# This file contains terms and their lemma forms as determined by the POS
# tagger TreeTagger. DIAsDEM Workbench 2.1 can only process single-token
# terms (e.g., 'ist') which do not contain blank spaces. Terms are not
# looked up case-sensitively. Hence, both terms 'ist' and 'IST' will be
# mapped onto the grammatical root 'sein'. Each line contains exactly one
# term and its lemma form separated by exactly one tab stop. This file was
# created by the DIAsDEM task Actions -> Prepare Data Set -> Lemmatize
# Text Units using the advanced option 'Create New Known Lemma Forms File'.
Spedition	Spedition
Beschluß	Beschluß
Bundesanzeiger	Bundesanzeiger
Catering	Catering
Veranstaltungsorganisation	Veranstaltungsorganisation
Europäischen	europäisch
V	V
Auf	auf
Recht	Recht
können	können
Übernehmenden	übernehmend
dem	d
frei	frei
Sie	Sie
Vermögens	Vermögen
Frank	Frank
schriftlich	schriftlich
Tischlerei	Tischlerei
Amts	Amt
Gefährdung	Gefährdung
erfolgt	erfolgen
EGV	EGV
des	d
Übertragung	Übertragung
Firma	Firma
Meisel	Meisel
Charlottenburg	Charlottenburg
Rat	Rat
Systeme	System
seit	seit
Spaltungsvertrag	Spaltungsvertrag
formwechselnd	formwechselnd
Frischdienst	Frischdienst
Essen	Essen
KG	KG
zusammen	zusammen
Teile	Teil
Wasser	Wasser
Nunsdorf	Nunsdorf
Oberrot	Oberrot
beanspruchen	beanspruchen
Ausgliederungs	Ausgliederungs
Koschel	Koschel
Bekanntmachung	Bekanntmachung
l	l
entstandenen	entstanden
Anspruch	Anspruch
gefährdet	gefährden
erst	erst
im	im
Spaltung	Spaltung
Verschmelzungsvertrag	Verschmelzungsvertrag
Sanitär	sanitär
haftende	haftend
ihren	ihr
umgewandelt	umwandeln
Grund	Grund
aus	aus
Aufgrund	aufgrund
Horst	Horst
Umwandlungsgesetz	Umwandlungsgesetz
Martin	Martin
agromax	agromax
Rechtsform	Rechtsform
Personennahverkehrsgesellschaft	Personennahverkehrsgesellschaft
Wachschutz	Wachschutz
Aurich	Aurich
Lienemann	Lienemann
sich	sich
Otto	Otto
Johann	Johann
dessen	d
Neugründung	Neugründung
Spaltungsvertrages	Spaltungsvertrages
Ihnen	Ihnen
mbH	mbH
Ausschluß	Ausschluß
J.	J.
Engel	Engel
eingetreten	eintreten
abgespalten	abspalten
jeweils	jeweils
zur	zur
betriebene	betrieben
machen	machen
Tage	Tag
desjenigen	desjenigen
Dahme	Dahme
Gasthof	Gasthof
UmwG	UmwG
Gesellscfhaft	Gesellscfhaft
Nagel	Nagel
Monaten	Monat
sofort	sofort
Inhaber	Inhaber
beendet	beenden
Chemco	Chemco
Teßmer	Teßmer
ausgeschieden	ausscheiden
Änderung	Änderung
Von	von
gemacht	machen
Erfüllung	Erfüllung
Wege	Weg
Friedersdorf	Friedersdorf
ihres	ihr
Energietechnik	Energietechnik
Rathenow	Rathenow
FGG	FGG
EUR	EUR
Luckenwalde	Luckenwalde
Gläubiger	Gläubiger
Zossen	Zossen
Umrechnungskurs	Umrechnungskurs
Ausgliederung	Ausgliederung
Jütro	Jütro
Engelberta	Engelberta
Höhe	Höhe
Kroh	Kroh
DM	DM
aufgehoben	aufheben
künftig	künftig
hier	hier
Liquidators	Liquidator
Den	d
und	und
ff.	ff.
Michael	Michael
übertragen	übertragen
Stechow	Stechow
Konservenfabrik	Konservenfabrik
zustimmenden	zustimmend
Euromedien	Euromedium
Service	Service
zum	zum
Gesellschaften	Gesellschaft
Wertstoffaufbereitungs	Wertstoffaufbereitungs
Langerwisch	Langerwisch
Durch	durch
Steuerberatungsgesellschaft	Steuerberatungsgesellschaft
Glindow	Glindow
Gesellschafterbeschlüsse	Gesellschafterbeschlüsse
Chemie	Chemie
nur	nur
Modehaus	Modehaus
Verlegung	Verlegung
HRB	HRB
Uwe	Uwe
Manfred	Manfred
bizzcomm	bizzcomm
Zweigniederlassung	Zweigniederlassung
nach	nach
Alleingesellschafterin	Alleingesellschafterin
Daniela	Daniela
ist	sein
Unternehmen	Unternehmen
Stammkapitals	Stammkapital
SAFE	Safe
Klenk	Klenk
bekannt	bekannt
Alleingesellschafters	Alleingesellschafters
Verkehrsgesellschaft	Verkehrsgesellschaft
Tag	Tag
Noack	Noack
Güterverwaltung	Güterverwaltung
Grube	Grube
Sanitärinstallation	Sanitärinstallation
a.d.	a.d.
Hauptversammlung	Hauptversammlung
neuen	neu
bestellt	bestellen
Elsen	Elsen
gemäß	gemäß
Gesellschaferversammlung	Gesellschaferversammlung
Wünsdorf	Wünsdorf
Gerd	Gerd
an	an
Verschmelzungsvertrages	Verschmelzungsvertrages
Sicherheit	Sicherheit
berufen	berufen
e.K.	e.K.
FOOD	food
Holzwerke	Holzwerke
Fess	Fess
Dieses	dies
Hartz	Hartz
dass	dass
ohne	ohne
PVN	PVN
persönlich	persönlich
Diese	dies
übergegangen	übergehen
vom	vom
AWE	AWE
Falkensee	Falkensee
Gesellschaft_mit_beschränkter_Haftung	Gesellschaft_mit_beschränkter_Haftung
Erhöhung	Erhöhung
Satz	Satz
für	für
Bohlen	Bohle
Formwechsels	Formwechsels
anderen	ander
ihrer	ihr
Rietz	Rietz
Potsdam	Potsdam
erlangen	erlangen
ff	ff
verschmolzen	verschmelzen
Ketzin	Ketzin
co.don	co.don
Registergericht	Registergericht
alleinvertretungsberechtigt	alleinvertretungsberechtigt
Bestensee	Bestensee
neuer	neu
Rechtsträgers	Rechtsträger
Betriebsteil	Betriebsteil
Speditions	Speditions
daß	daß
unter	unter
Gas	Gas
Beschluss	Beschluss
wegen	wegen
Jüterbog	Jüterbog
seines	sein
Kommanditistin	Kommanditistin
worden	werden
Mögelin	Mögelin
Geschäftsführer	Geschäftsführer
derjenigen	derjenigen
jedoch	jedoch
Digital	digital
Euro	Euro
bei	bei
Aufbereitung	Aufbereitung
um	um
gem.	gem.
leisten	leisten
Sitz	Sitz
Abfallwirtschaft	Abfallwirtschaft
Königs	Königs
Haftung	Haftung
Umstellung	Umstellung
Die	d
Heino	Heino
Register	Register
Car	Car
Betriebs	Betrieb
Gesellschaft	Gesellschaft
beschränkter	beschränkt
Sicherheitsleistung	Sicherheitsleistung
Vertretungsbefugnis	Vertretungsbefugnis
vertritt	vertreten
Media	Media
Alfred	Alfred
Umwandlung	Umwandlung
T.	T.
e.Kfm.	e.Kfm.
erfolgten	erfolgt
Gesellschaftsmitteln	Gesellschaftsmitteln
Rechtsträger	Rechtsträger
anmelden	anmelden
umgewandelten	umgewandelt
Rotberg	Rotberg
Forderung	Forderung
Sitzes	Sitz
die	d
Pfeil	Pfeil
Hotel	Hotel
binnen	binnen
Liquidation	Liquidation
eingetragen	eintragen
Kiesgrube	Kiesgrube
Brandenburg	Brandenburg
Abwasser	Abwasser
haben	haben
Bremen	Bremen
Beschlusses	Beschluß
Kommanditisten	Kommanditist
Scholz	Scholz
aufgrund	aufgrund
GmbH_&_Co._KG	GmbH_&_Co._KG
beider	beide
Nutzfahrzeughandel	Nutzfahrzeughandel
der	d
ausgegliedert	ausgliedern
aufgelöst	auflösen
K.	K.
Handelsregister	Handelsregister
Der	d
Union	Union
anzumelden	anmelden
gleichzeitigen	gleichzeitig
Truck	Truck
Finish	Finish
gleichzeitige	gleichzeitig
oder	oder
Geschäftsführerin	Geschäftsführerin
Babelsberg	Babelsberg
Treuenbrietzen	Treuenbrietzen
Gesellschafterin	Gesellschafterin
Baubetreuungs	Baubetreuungs
Regionale	Regionale
wenn	wenn
Hauptniederlassung	Hauptniederlassung
wird	werden
Braach	Braach
Engineering	Engineering
Jänsch	Jänsch
Amtsgericht	Amtsgericht
e.	e.
Recycling	Recycling
beschlossen	beschließen
den	d
Michendorf	Michendorf
Havel	Havel
III	III
Befriedigung	Befriedigung
gelöscht	löschen
firmierend	firmierend
Übernahmevertrages	Übernahmevertrag
Verwaltungsgesellschaft	Verwaltungsgesellschaft
geb.	Geb.
Er	er
zugestimmt	zustimmen
a	A
als	als
in	in
Umwandlungsgesetzes	Umwandlungsgesetzes
sie	sie
Corporation	Corporation
dieses	dies
dieser	dies
Lohr	Lohr
Zeesen	Zeese
AG	AG
Übertrages	Übertrages
ABAKUS	Abakus
Grundlage	Grundlage
Brieselang	Brieselang
Schulze	Schulze
Gerüstbau	Gerüstbau
am	am
Gerhard	Gerhard
Abwicklung	Abwicklung
verlangen	verlangen
Verwaltungs	Verwaltungs
Gerätewerk	Gerätewerk
Margit	Margit
mehr	mehr
GmbH	GmbH
nicht	nicht
RVS	RVS
Liquidatorin	Liquidatorin
Ausschluss	Ausschluss
Gesellschafterbeschluss	Gesellschafterbeschluss
steht	stehen
Cottbus	Cottbus
Harms	Harm
wirksam	wirksam
gilt	gelten
mit	mit
Kai	Kai
auf	auf
Gesellschafterversammlung	Gesellschafterversammlung
NAW	NAW
Muschert	Muschert
Spreewald	Spreewald
TSP	TSP
Arbor	Arbor
verlagen	Verlag
Kühne	Kühne
Kommunikation	Kommunikation
Beelitz	Beelitz
Verschmelzung	Verschmelzung
beim	beim
Art	Art
Vorkauf	Vorkauf
Abs.	Abs.
Kommanditist	Kommanditist
von	von
sind	sein
M.	M.
Werner	Werner
Bochum	Bochum
elegant	elegant
Gläubigern	Gläubiger
Eintragung	Eintragung
beteiligten	beteiligt
diese	dies
das	d
Gesellschafterversammlungen	Gesellschafterversammlung
Nauen	Nauen
Formwechsel	Formwechsel
Aufnahme	Aufnahme
Grundstücksgesellschaft	Grundstücksgesellschaft
Fichtenwalde	Fichtenwald
gleichzeitig	gleichzeitig
Das	d
Stammkapital	Stammkapital
soweit	soweit
Abspaltung	Abspaltung
Nr.	Nr.
angemeldet	anmelden
Prokuristen	Prokurist
Heizung	Heizung
Klausdorf	Klausdorf
selben	selb
Aktiengesellschaft	Aktiengesellschaft
Gleiche	gleich
Luckau	Luckau
geworden	werden
ihrem	ihr
Auflösung	Auflösung
durch	durch
Fassung	Fassung
Ingenieure	Ingenieur
einem	ein
übernehmenden	übernehmend
UmwBerG	UmwBerG
glaubhaft	glaubhaft
sechs	sechs
Nuthetal	Nuthetal
Berlin	Berlin
ihnen	sie
K	K
AVECS	AVECS
Bittner	Bittner
Kraftfahrzeugservice	Kraftfahrzeugservice
bekanntgemacht	bekanntgemacht
INSTA	INSTA
erlochen	erlochen
zu	zu
Forderungen	Forderung
Ganzes	Ganze
Vertragsergänzung	Vertragsergänzung
festgelegten	festgelegt
erloschen	erlöscht
es	es
gleichen	gleich
hat	haben
sowie	sowie
Bauberatungs	Bauberatungs
Co.	Co.
wurde	werden
Wiesmoor	Wiesmoor
Nachtrag	Nachtrag
Edgar	Edgar
Doyen	Doyen
BSV	BSV
DEGA	DEGA
deren	d
daher	daher
Vorschriften	Vorschrift
Gesellschaftsvertrages	Gesellschaftsvertrag
Allservice	Allservice
bisherige	bisherig
Vermögen	Vermögen
Teltow	Teltow
RCM	RCM
übertragenden	übertragend
Techniker	Techniker
Beschlüsse	Beschluß
Nicht	nicht
Fredrich	Fredrich
Gesamtheit	Gesamtheit
Wusterhausen	Wusterhausen
Paretz	Paretz
