# This file contains terms and their lemma forms as determined by the POS
# tagger TreeTagger. DIAsDEM Workbench 2.1 can only process single-token
# terms (e.g., 'ist') which do not contain blank spaces. Terms are not
# looked up case-sensitively. Hence, both terms 'ist' and 'IST' will be
# mapped onto the grammatical root 'sein'. Each line contains exactly one
# term and its lemma form separated by exactly one tab stop. This file was
# created by the DIAsDEM task Actions -> Prepare Data Set -> Lemmatize
# Text Units using the advanced option 'Create New Known Lemma Forms File'.
Datenverarbeitungssysteme	Datenverarbeitungssystem
Arbeitsgemeinschaften	Arbeitsgemeinschaft
Formaten	Format
Deetz	Deetz
Fanartikel	Fanartikel
Biographien	Biographie
Dettmers	Dettmers
Dabendorf	Dabendorf
Verkehrsbau	Verkehrsbau
Bubner	Bubner
Rüsselsheim	Rüsselsheim
Verlag	Verlag
Projektierungen	Projektierungen
Direct	Direct
Jan	Jan
Lübbenau	Lübbenau
Alex	Alex
Keramik	Keramik
Diehn	Diehn
Kubitz	Kubitz
Sanar	Sanar
Aufgabenstellung	Aufgabenstellung
multimedialen	multimedialen
Verbesserung	Verbesserung
Franken	Franken
höhere	hoch
Böden	Boden
Subunternehmerleistungen	Subunternehmerleistungen
Landtechnik	Landtechnik
weitere	weit
devastierter	devastierter
Heyden	Heyden
Urban	urban
Filmverwertungsrechten	Filmverwertungsrechten
Große	Große
Partnergesellschaft	Partnergesellschaft
Lindenberg	Lindenberg
naturstein	naturstein
Böschungen	Böschung
Bildplatten	Bildplatten
Kinder	Kind
EGV	EGV
Kommunikationspraxis	Kommunikationspraxis
Unterstützung	Unterstützung
Immobiliengeschäften	Immobiliengeschäft
Zu	zu
beteiligt	beteiligen
Schülerbusverkehr	Schülerbusverkehr
Laden	Laden
Charlottenburg	Charlottenburg
Brosk	Brosk
Kotzias	Kotzias
Wasserzählern	Wasserzähler
Schädlich	schädlich
Trockenbau	Trockenbau
Kummersdorf	Kummersdorf
Haussprechanlagen	Haussprechanlagen
Elektro	Elektro
stiller	still
Obst	Obst
fortgesetzt	fortsetzen
Recyclingarbeiten	Recyclingarbeiten
Eiche	Eiche
Köln	Köln
Smits	Smits
Multiled	Multiled
Stefan	Stefan
Trimmpfade	Trimmpfad
Rolf	Rolf
Abschleppdienst	Abschleppdienst
Dipl.-Staatswissenschaftler	Dipl.-Staatswissenschaftler
Schröder	Schröder
Marlies	Marlies
Pflichten	Pflichten
Sondermaschinen	Sondermaschine
Beurteilung	Beurteilung
Zubehör	Zubehör
Schankwirtschaftsbetrieben	Schankwirtschaftsbetrieben
Probst	Probst
Wassertechnik	Wassertechnik
Zum	zum
Gewerbeobjekte	Gewerbeobjekt
Benn	Benn
dessen	d
Wirkung	Wirkung
Götze	Götze
Verkehr	Verkehr
OT	OT
Krefeld	Krefeld
Wartung	Wartung
Beirat	Beirat
Ahlhorn	Ahlhorn
Bepflanzen	Bepflanzen
Birkenstaedt	Birkenstaedt
entwickeln	entwickeln
einmal	einmal
Klemm	klemmen
Ausland	Ausland
Finanzbehörden	Finanzbehörde
Pay	Pay
Studien	Studien
Oschatz	Oschatz
amtliches	amtlich
biochemischen	biochemisch
Inhaber	Inhaber
Fertigbauwerken	Fertigbauwerken
Asphaltmischanlagen	Asphaltmischanlagen
Mitgeschäftsführungs	Mitgeschäftsführungs
Messerschmidt	Messerschmidt
leistungsorientiertem	leistungsorientiertem
Energieoptimierung	Energieoptimierung
Masur	Masur
Riesbeck	Riesbeck
Bautechnik	Bautechnik
Erlaubnis	Erlaubnis
Polizei	Polizei
Global	global
S.	S.
RM	RM
Höß	Höß
Strauch	Strauch
Weiterbildungsveranstaltungen	Weiterbildungsveranstaltung
Voß	Voß
Grundstücke	Grundstück
Accountant	Accountant
Ausgliederung	Ausgliederung
Investoren	Investor
Langenhagen	Langenhagen
Baudienstleistungen	Baudienstleistungen
Tragwerkplanung	Tragwerkplanung
Stammeinlagen	Stammeinlagen
Freizeitanlagen	Freizeitanlage
nonfood	nonfood
Erkenntnisse	Erkenntnis
historischen	historisch
Massiv	Massiv
Forschungsergebnisse	Forschungsergebnis
und	und
Zubehörteilen	Zubehörteilen
Camel	Camel
Barembruch	Barembruch
Gasheizungsanlagen	Gasheizungsanlagen
Diensten	Dienst
Klimatechnikanlagenservice	Klimatechnikanlagenservice
Schwaiger	Schwaiger
Begleitung	Begleitung
Service	Service
Matschke	Matschke
Verlags	Verlag
angrenzenden	angrenzend
Infrastrukturen	Infrastruktur
Annahme	Annahme
tätigen	tätigen
Geschäftsbereiche	Geschäftsbereich
darüberhinausgehende	darüberhinausgehende
Metallfertigteilen	Metallfertigteilen
Last	Last
Frieder	Frieder
Einzelnen	einzeln
branchenverwandten	branchenverwandten
Papier	Papier
Winfried	Winfried
Maas	Maas
Shops	Shops
Bäderausstattungen	Bäderausstattungen
Backstuben	Backstube
Millenium	Millenium
Makler	Makler
entsprechenden	entsprechend
Import	Import
Toren	Tor
Gritz	Gritz
Landkreises	Landkreis
graphischen	graphisch
Stahlberg	Stahlberg
gewerblichen	gewerblich
freies	frei
Ursprungs	Ursprung
Dipl.-Ing.	Dipl.-Ing.
Monitoringsystemen	Monitoringsystemen
betriebsnotwendigen	betriebsnotwendig
Ricco	Ricco
Filmrechte	Filmrechte
Rehatechnik	Rehatechnik
Umwelttechnik	Umwelttechnik
Abschlusses	Abschluß
Sterner	Sterner
Hensel	Hensel
Gardinen	Gardine
Herzog	Herzog
Hirsch	Hirsch
Käse	Käse
Oliver	Oliver
Ausbauarbeiten	Ausbauarbeiten
Falkensee	Falkensee
Körperschaften	Körperschaft
Kienitz	Kienitz
gemietetem	gemietet
Gesch	Gesch
j	J
Wutke	Wutke
Registrierung	Registrierung
Ralph	Ralph
Palm	Palm
Anwendungen	Anwendung
Wibe	Wibe
GaWa	GaWa
Gewerbebauten	Gewerbebau
Markenartikeln	Markenartikel
Schlußbestimmungen	Schlußbestimmung
Neuenhagen	Neuenhagen
co.don	co.don
Mineralgemischen	Mineralgemischen
Bausystemen	Bausystemen
Fliesen	Fliesen
Wandelt	wandeln
Kleinmachnow	Kleinmachnow
Zachow	Zachow
Grünanlagenbau	Grünanlagenbau
Bartosz	Bartosz
Wietstock	Wietstock
Grundlagenfächer	Grundlagenfächer
Einlage	Einlage
wegen	wegen
ortsfesten	ortsfest
Windt	Windt
Erkennungsmelodie	Erkennungsmelodie
Hörfunk	Hörfunk
Woldenberg	Woldenberg
Entwicklung	Entwicklung
Gastronomischen	gastronomisch
Geschäftsführer	Geschäftsführer
Lerm	Lerm
AKAT	AKAT
Klausdieter	Klausdieter
BILF	BILF
Ägypten	Ägypten
mobil	mobil
Abdichtungsarbeiten	Abdichtungsarbeiten
Uptrup	Uptrup
bei	bei
Renovierung	Renovierung
Jurk	Jurk
sortimentsgerechte	sortimentsgerechte
Bewertung	Bewertung
Besetzung	Besetzung
Wohnobjekten	Wohnobjekt
Hübel	Hübel
Agrargenossenschaft	Agrargenossenschaft
Baufertigteilen	Baufertigteilen
Einbauküchen	Einbauküche
Saunaanlagen	Saunaanlagen
Fedor	Fedor
mechanischer	mechanisch
Mosaik	Mosaik
Beschaffenheit	Beschaffenheit
Cramer	Cramer
Krummensee	Krummensee
Janik	Janik
nachstationärer	nachstationärer
Alarmanlagen	Alarmanlage
Schädlingsbekämpfung	Schädlingsbekämpfung
so	so
Versicherten	Versicherte
bearbeitetem	bearbeitet
öffentlichkeitswirksame	öffentlichkeitswirksam
komplexer	komplex
psychotherapeutischen	psychotherapeutisch
Mediensysteme	Mediensystem
Flurstücke	Flurstücke
Anlage	Anlage
Heizkostenverteilern	Heizkostenverteilern
Deneyen	Deneyen
Methodik	Methodik
Kaula	Kaula
online	online
Florijn	Florijn
Kunzendorf	Kunzendorf
Bauaufträgen	Bauauftrag
Franzen	Franzen
Geschäftsbesorgungen	Geschäftsbesorgungen
Marco	Marco
Unternehmensneugründungen	Unternehmensneugründung
Mühmel	Mühmel
Rahmel	Rahmel
Auftragsentwicklung	Auftragsentwicklung
akustischen	akustisch
Loroch	Loroch
Kunert	Kunert
Europe	Europe
GIAS	GIAS
einlagen	Einlage
Ergebnisabführungsvertrag	Ergebnisabführungsvertrag
Schmuck	Schmuck
Maschinen	Maschine
Profinanz	Profinanz
Wissenschaft	Wissenschaft
käuflicher	käuflich
Arabische	Arabische
Gruppen	Gruppe
Scharnowski	Scharnowski
Kinderheimes	Kinderheim
erhöhen	erhöhen
Materialien	Material
Gaertner	Gaertner
Outlet	Outlet
Bauhandwerkerleistungen	Bauhandwerkerleistungen
einziger	einzig
ehemaligen	ehemalig
Industriebereich	Industriebereich
Coaching	Coaching
Einrichtungen	Einrichtung
Zeitabständen	Zeitabstand
Schwarz	Schwarz
Umsiedlungsmaßnahmen	Umsiedlungsmaßnahme
Sende	senden
Reinicke	Reinicke
ausführen	ausführen
Dallgow	Dallgow
Verrichtung	Verrichtung
Potsdsam	Potsdsam
weshalb	weshalb
Elektrogeräten	Elektrogerät
Kay	Kay
Gudrun	Gudrun
Telefon	Telefon
Martina	Martina
Dritter	Dritte
genormter	genormt
Wulf	Wulf
Vello	Vello
gehören	gehören
Personen	Person
mehrerer	mehrerer
Büroservices	Büroservices
gepachtetem	gepachtet
Stammeinlage	Stammeinlage
Menschen	Mensch
Gerüstbau	Gerüstbau
Ferienhäusern	Ferienhaus
Süchting	Süchting
Petra	Petra
genutzten	genutzt
Scheibe	Scheibe
Sanitäreinrichtungen	Sanitäreinrichtung
Ladenausstattungen	Ladenausstattungen
Gründung	Gründung
DHS	DHS
Schwenke	schwenken
Karla	Karla
Gesetz	Gesetz
Minute	Minute
Arndt	Arndt
West	West
Paukstadt	Paukstadt
Altbauten	Altbau
Demper	Demper
Kickuth	Kickuth
Brandenburgische	Brandenburgische
Altbausektor	Altbausektor
Kolzenburg	Kolzenburg
Hoppe	Hoppe
Umwelt	Umwelt
Prüfungsbericht	Prüfungsbericht
Gesamtkonzeptionen	Gesamtkonzeption
Jasmin	Jasmin
Produktionsleitung	Produktionsleitung
audiovisuellen	audiovisuell
Präsentationen	Präsentation
wiederum	wiederum
Freizeit	Freizeit
Ozonanlagen	Ozonanlagen
Petrotschenko	Petrotschenko
Kreditbank	Kreditbank
Beratungsgesellschaft	Beratungsgesellschaft
Gala	Gala
Zirndorf	Zirndorf
Lindemann	Lindemann
Tischlereihandwerk	Tischlereihandwerk
Dollenberg	Dollenberg
Vertrag	Vertrag
Führt	führen
Comesana	Comesana
Staaten	Staat
Vergabe	Vergabe
Instrumenten	Instrument
Baumeister	Baumeister
Eigen	Eigen
Bewerbern	Bewerber
Treibstoff	Treibstoff
Tennis	Tennis
Röllig	Röllig
Verputz	Verputz
Kirscht	Kirscht
Vermögenswerten	Vermögenswerten
PanMedium	PanMedium
Steven	Steven
Bückchen	Bückchen
Schulungen	Schulung
Bausparkassenverträgen	Bausparkassenverträgen
Verbindlichkeiten	Verbindlichkeit
Centurio	Centurio
Publizierens	Publizieren
Strosny	Strosny
REB	REB
Städtebau	Städtebau
Solaranlagen	Solaranlage
Bilanz	Bilanz
Erdgas	Erdgas
Sammt	Sammt
Nüsse	Nuß
angemeldet	anmelden
Prister	Prister
DENALI	DENALI
Mark	Mark
Controlling	Controlling
Wohngebäude	Wohngebäude
Reckling	Reckling
andere	ander
folgender	folgend
Rünthe	Rünthe
Trockenausbau	Trockenausbau
Heizung	Heizung
Kreditwesen	Kreditwesen
Büttner	Büttner
industrielle	industriell
Hinz	Hinz
beide	beide
Baustelleneinrichtung	Baustelleneinrichtung
Sicherheitsfragen	Sicherheitsfragen
Verlust	Verlust
unabhängige	unabhängig
Schlosserarbeiten	Schlosserarbeiten
Roswitha	Roswitha
Carmen	Carmen
Berend	Berend
Prieser	Prieser
Sonderrechtsnachfolge	Sonderrechtsnachfolge
betreffend	betreffend
kranke	krank
Hellmann	Hellmann
Estricharbeiten	Estricharbeiten
Abfragesystemen	Abfragesystemen
Verrechnungsdienstleistungen	Verrechnungsdienstleistungen
Arthur	Arthur
Softwarebetreuung	Softwarebetreuung
mehrer	mehrer
Karcher	Karcher
Dengler	Dengler
Heinig	Heinig
vorstehende	vorstehend
Ortwein	Ortwein
Bebauung	Bebauung
Hilfe	Hilfe
Haven	Haven
Gummierzeugnissen	Gummierzeugnissen
Geschäftsfsührungs	Geschäftsfsührungs
Echterdingen	Echterdingen
Erdarbeiten	Erdarbeiten
Tappert	Tappert
Warenverkehr	Warenverkehr
Sitzverlegung	Sitzverlegung
OHG	OHG
Jäckel	Jäckel
Gebrauchtfahrzeugen	Gebrauchtfahrzeugen
Bauelementen	Bauelement
Urstromtal	Urstromtal
Nikolaus	Nikolaus
Standardprodukten	Standardprodukt
Lagerei	Lagerei
Bedrucken	Bedrucken
Einkaufszentrum	Einkaufszentrum
Festzeltverleih	Festzeltverleih
Laske	Laske
Fertigschriften	Fertigschriften
Gesellschaftszweck	Gesellschaftszweck
mittelständischen	mittelständisch
i.S.d.	i.S.d.
Kücheneinrichtungen	Kücheneinrichtung
Etna	Etna
Medizintechnik	Medizintechnik
konsekutiven	konsekutiven
Drahtverarbeitung	Drahtverarbeitung
Hosting	Hosting
Heß	Heß
Aufbau	Aufbau
Aufstellen	Aufstellen
Junges	Junge
beruhenden	beruhend
Lärmschutzeinrichtungen	Lärmschutzeinrichtung
Abfallwirtschaftsbetrieb	Abfallwirtschaftsbetrieb
Network	Network
Imbissen	Imbiß
Landschaftsbaues	Landschaftsbaues
geschaffenen	geschafft
Kühnappel	Kühnappel
Auslandes	Ausland
Göbel	Göbel
Synthese	Synthese
flexografische	flexografische
Servicedienste	Servicedienst
höchstens	höchstens
Bertus	Bertus
Tauchsportartikeln	Tauchsportartikeln
Begutachtung	Begutachtung
HAUS	hausen
Windparks	Windpark
Möbeldienstleistungen	Möbeldienstleistungen
Dramaturgie	Dramaturgie
Schienen	Schiene
Landwehrmann	Landwehrmann
Schlossereiarbeiten	Schlossereiarbeiten
kaufen	kaufen
Bauten	Bau
Schuttberäumung	Schuttberäumung
Betana	Betana
Bauaufzügen	Bauaufzügen
heilkundlichen	heilkundlichen
Regeltechnik	Regeltechnik
Dach	Dach
Selmar	Selmar
Bestandsobjekte	Bestandsobjekte
Oldenburg	Oldenburg
Bauleitungen	Bauleitungen
Landstraße	Landstraße
Bassinger	Bassinger
Softwaresysteme	Softwaresysteme
schriftlich	schriftlich
Systemanalyse	Systemanalyse
Heiks	Heiks
Leitungen	Leitung
Pfeifer	Pfeifer
Seliger	Selige
des	d
Stipendien	Stipendium
Parreidt	Parreidt
fachgerechte	fachgerecht
Landschaftsgestaltung	Landschaftsgestaltung
Sportbekleidung	Sportbekleidung
Spielervermittlung	Spielervermittlung
Wildenburch	Wildenburch
geräte	Gerät
erhalten	erhalten
Konstruktionsbüros	Konstruktionsbüro
Beleuchtungskörpern	Beleuchtungskörper
Rendsburg	Rendsburg
Fassadensanierung	Fassadensanierung
Fahrzeugreinigung	Fahrzeugreinigung
Essen	Essen
Subunternehmern	Subunternehmern
Tiefbau	Tiefbau
Zweite	zweit
J.J.	J.J.
Usingen	Usingen
Neben	neben
Richter	Richter
berufstypischen	berufstypisch
Handschumacher	Handschumacher
Metallprodukten	Metallprodukten
Milchvieh	Milchvieh
Kiebert	Kiebert
Medienpark	Medienpark
folgenden	folgend
Aibling	Aibling
Amtsgerichts	Amtsgericht
Köppe	Köppe
Abteilungen	Abteilung
Eigentums	Eigentum
Tertel	Tertel
konkreten	konkret
Karlheinz	Karlheinz
Crampe	Crampe
ambulanter	ambulant
Kirchmöser	Kirchmöser
Sandowski	Sandowski
Künzelmann	Künzelmann
Tür	Tür
Martin	Martin
Behinderte	Behinderte
Beinhauer	Beinhauer
Erftstadt	Erftstadt
Gesamtzustandes	Gesamtzustandes
erscheinen	erscheinen
SHK	SHK
Behinderten	Behinderte
Chrysler	Chrysler
Exportgeschäfte	Exportgeschäft
Computeranlagen	Computeranlage
Plattenlegearbeiten	Plattenlegearbeiten
Arbeits	Arbeits
Digitale	Digitale
Hauptgesellschaft	Hauptgesellschaft
Polyäthyleen	Polyäthyleen
zur	zur
Einzelvertreterbefugnis	Einzelvertreterbefugnis
betriebene	betrieben
Mitarbeiter	Mitarbeiter
Hannemann	Hannemann
Fortentwicklung	Fortentwicklung
Bausparverträge	Bausparvertrag
Clalüna	Clalüna
Pflanzen	Pflanzen
gemeinsame	gemeinsam
Gesellschaftszweckes	Gesellschaftszweckes
h	h
gefasst	gefasst
Konzeptionen	Konzeption
Schubert	Schubert
Bodenaushub	Bodenaushub
Gewerberaum	Gewerberaum
Schütter	schütter
Siebenpfeiffer	Siebenpfeiffer
ähnliche	ähnlich
Betreibern	Betreiber
Erfüllung	Erfüllung
Quarzwerkes	Quarzwerkes
Herstellern	Hersteller
Softwarelösungen	Softwarelösung
Projektierung	Projektierung
Mitgliederverträge	Mitgliederverträge
Baugrundstücken	Baugrundstück
Logo	logo
Gläubiger	Gläubiger
Anemone	Anemone
Wintergärten	Wintergarten
Produktionsprozeßentwicklung	Produktionsprozeßentwicklung
Herczeg	Herczeg
Geltow	Geltow
Mann	Mann
Es	es
Cotton	Cotton
Fort	Fort
besteht	bestehen
Teerbau	Teerbau
Mehlsdorf	Mehlsdorf
Person	Person
Wirtschaftsbilanzen	Wirtschaftsbilanz
Maurer	Maurer
Pflegedienst	Pflegedienst
Tonny	Tonny
Assemblierung	Assemblierung
Projektentwicklungs	Projektentwicklungs
Küchenhoff	Küchenhoff
Salaten	Salat
Nebengewerbes	Nebengewerbes
Lagerräumen	Lagerräumen
Bürovermietung	Bürovermietung
Einzelvertretung	Einzelvertretung
Deutsch	deutsch
Naumann	Naumann
Friesack	Friesack
Bestimmung	Bestimmung
Technik	Technik
Fläming	Fläming
Firmensitz	Firmensitz
Apparate	Apparat
GVV	GVV
gleichzeitiger	gleichzeitig
Abrechnung	Abrechnung
ETW	ETW
Schomers	Schomers
Ottmar	Ottmar
Kurt	Kurt
Geschäftsanteilen	Geschäftsanteilen
Günther	Günther
genommen	nehmen
Bauwerkverträgen	Bauwerkverträgen
Arbeiten	Arbeiten
Kraus	Kraus
Lotto	Lotto
mehrmals	mehrmals
Name	Name
Mete	Mete
Abfüllen	Abfüllen
sondern	sondern
fremder	fremd
Grüger	Grüger
Eigenblutkonserven	Eigenblutkonserve
Bauwerksanalysen	Bauwerksanalysen
Sinne	Sinn
derartigen	derartig
Sonnenschutzartikeln	Sonnenschutzartikeln
Rohbau	Rohbau
Baugeräten	Baugerät
Ingolf	Ingolf
WORKSHOPS	Workshop
Diese	dies
Raumes	Raumes
außerordentliche	außerordentlich
Petersen	Petersen
Dementsprechend	dementsprechend
Fachfirmen	Fachfirmen
Zusatzaggregaten	Zusatzaggregaten
Geldanlagen	Geldanlage
Ausgabe	Ausgabe
BauKITT	BauKITT
Aufsichtsrats	Aufsichtsrat
eigenem	eigen
v.	von
Recep	Recep
Innenausbaus	Innenausbau
Nutzung	Nutzung
Nutzfahrzeugen	Nutzfahrzeug
ihrer	ihr
Onken	Onken
Luxembourg	Luxembourg
Birgit	Birgit
Kontrolle	Kontrolle
Mosaiklegerarbeiten	Mosaiklegerarbeiten
Lagergeschäfte	Lagergeschäfte
Fertigungsbetriebe	Fertigungsbetrieb
Erzsebet	Erzsebet
Baustoffrecyclingmaterial	Baustoffrecyclingmaterial
Einzugsgebiet	Einzugsgebiet
Köris	Köris
Konzession	Konzession
Bedienungspersonal	Bedienungspersonal
Subunternehmen	Subunternehmen
Bautenschuzarbeiten	Bautenschuzarbeiten
Randolf	Randolf
Rechtsträgers	Rechtsträger
Transportleistungen	Transportleistung
Erbfall	Erbfall
Neuanlage	Neuanlage
Kofinanzierungen	Kofinanzierungen
polnischem	polnisch
Hoevedorp	Hoevedorp
Flughäfen	Flughafen
H	H
Touristenservice	Touristenservice
Smuda	Smuda
Analyse	Analyse
Gert	Gert
Behnecke	Behnecke
Joe	Joe
Betonpumpen	Betonpumpen
erforderliche	erforderlich
Niyazi	Niyazi
Euro	Euro
Rüdiger	Rüdiger
h.	heißen
HOAI	HOAI
Ziffern	Ziffer
Bensheim	Bensheim
Buchberg	Buchberg
Gartenkleinmöbel	Gartenkleinmöbel
geschlossene	geschlossen
Handelskontakten	Handelskontakten
Y	Y
Textilien	Textilie
Dachbegrünungen	Dachbegrünungen
Haftung	Haftung
Stadtverwaltung	Stadtverwaltung
tennisspezifischem	tennisspezifischem
Tolls	Tolls
Vermögensbildung	Vermögensbildung
Funktionsräumen	Funktionsräumen
Accessoires	Accessoire
Pflegebedürftige	Pflegebedürftige
Vorbereitung	Vorbereitung
Sicherheitsleistung	Sicherheitsleistung
Mohr	Mohr
Alfred	Alfred
Lackierer	Lackierer
Dämmstoffen	Dämmstoff
Dienstleistungs	Dienstleistungs
Möthlitz	Möthlitz
Gerüstbauarbeiten	Gerüstbauarbeiten
Ländern	Land
Hausmeisterdiensten	Hausmeisterdiensten
Borkowski	Borkowski
Sitzes	Sitz
entwickelten	entwickelt
Souci	Souci
Bestückung	Bestückung
Hotel	Hotel
Zimmererarbeiten	Zimmererarbeiten
Hauselementen	Hauselementen
Werbeagentur	Werbeagentur
Herausgabe	Herausgabe
tritt	treten
Sticha	Sticha
Khisro	Khisro
Butzow	Butzow
CD	CD
Baubranche	Baubranche
Afrika	Afrika
Ines	Ines
Informatiker	Informatiker
Abbrucharbeiten	Abbrucharbeiten
Bohrpfahl	Bohrpfahl
Anmietung	Anmietung
konzipierte	konzipiert
dürfen	dürfen
Germer	Germer
K.	K.
Steuerung	Steuerung
Fürst	Fürst
Wanner	Wanner
Gottberg	Gottberg
Bezug	Bezug
Ersatzteile	Ersatzteil
Heidi	Heidi
weitergehenden	weitergehend
Projektabwicklung	Projektabwicklung
Steuerungstechnik	Steuerungstechnik
Werkstein	Werkstein
Stramm	stramm
vorliegen	vorliegen
Bühl	Bühl
Architekturbüros	Architekturbüro
Urproduktion	Urproduktion
Falk	Falk
artgleiche	artgleiche
Scherret	Scherret
Peiffer	Peiffer
Plewka	Plewka
Schluckwerder	Schluckwerder
Sensor	Sensor
Bauwerksverträgen	Bauwerksverträgen
Harm	Harm
offensive	offensiv
Amtsblatt	Amtsblatt
Slupinski	Slupinski
Bretten	Bretten
Frequenzen	Frequenz
Sammlung	Sammlung
Dachrinnenreinigung	Dachrinnenreinigung
dieser	dies
Wiese	Wiese
Satzkorn	Satzkorn
Grosse	Grosse
Holzrahmenbau	Holzrahmenbau
Unterkonstruktionen	Unterkonstruktionen
Branchen	Branche
Marko	Marko
Kilian	Kilian
einschlägigen	einschlägig
Liane	Liane
GmbH	GmbH
gastronomische	gastronomisch
Kenn	kennen
Beschäftigung	Beschäftigung
Humbach	Humbach
J.P.	J.P.
ihm	er
Gesellschaftsvermögens	Gesellschaftsvermögens
Tragwerke	Tragwerke
Straßenfahrzeuge	Straßenfahrzeug
Trautwein	Trautwein
Bucke	Bucke
Rehabilitation	Rehabilitation
freiwilliger	freiwillig
Frenzel	Frenzel
Dichtungen	Dichtung
Alfons	Alfons
Dreistadt	Dreistadt
Web	Web
Studio	Studio
Belger	Belger
vertretungsbefugt	vertretungsbefugt
Anbau	Anbau
Spreewald	Spreewald
Blank	Blank
Veröffentlichung	Veröffentlichung
Kassel	Kassel
bebauten	bebaut
Annemarie	Annemarie
Mauerwerks	Mauerwerk
Egsdorf	Egsdorf
Guido	Guido
Bauschuttrecycling	Bauschuttrecycling
Bäckereierzeugnissen	Bäckereierzeugnissen
Simonov	Simonov
Welzheim	Welzheim
Pierre	Pierre
Kommunikation	Kommunikation
Reinhold	Reinhold
Art	Art
Bodenbelägen	Bodenbelag
Lederwaren	Lederware
betriebenes	betrieben
sämtliche	sämtlich
Habichtswald	Habichtswald
Haseldorf	Haseldorf
Erlaubnisse	Erlaubnis
Fachpersonal	Fachpersonal
EU	EU
betriebe	betreiben
Antiquitäten	Antiquität
Komed	Komed
keinen	kein
Tennisplätzen	Tennisplatz
Jugendliche	Jugendliche
gleichartige	gleichartig
Neves	Neves
Loth	Loth
Hermannswerder	Hermannswerder
errichteten	errichtet
Nachweis	Nachweis
Erzeugnung	Erzeugnung
erlaubnisfrei	erlaubnisfrei
Havellandhalle	Havellandhalle
Stammkapital	Stammkapital
Zustimmungsbedürftige	zustimmungsbedürftig
speziellen	speziell
Halle	Halle
Professional	Professional
Zuführung	Zuführung
abgeschlossenen	abgeschlossen
Kunde	Kunde
Trinkwasserbehandlungsanlagen	Trinkwasserbehandlungsanlagen
Walther	Walther
Fabiola	Fabiola
Realisierung	Realisierung
Maschinelle	maschinell
Laux	Laux
genormte	genormt
Vermögensverwaltungsgesellschaft	Vermögensverwaltungsgesellschaft
überarbeiten	überarbeiten
Bestandteilen	Bestandteilen
Internationale	international
Jakobskrüger	Jakobskrüger
Gewerbeeinrichtungen	Gewerbeeinrichtung
Hendrik	Hendrik
Kurier	Kurier
Steuerungen	Steuerung
Werkzeugmaschinen	Werkzeugmaschine
Speditionsgeschäft	Speditionsgeschäft
therapeutischen	therapeutisch
Kahlenborn	Kahlenborn
Löbau	Löbau
Kraftwerk	Kraftwerk
einschl.	einschl.
Spielwaren	Spielware
Ausbildungs	Ausbildungs
Reststoffen	Reststoff
erforderlich	erforderlich
Fernsehen	Fernsehen
Menzel	Menzel
Konferenzgestaltung	Konferenzgestaltung
Putzer	Putzer
Unternehmenszweck	Unternehmenszweck
Wiedemann	Wiedemann
Gunter	Gunter
Ljubinka	Ljubinka
Filme	Film
Holding	Holding
Carel	Carel
autorisierte	autorisiert
Praxisbedarf	Praxisbedarf
erworbenen	erworben
Baureifmachung	Baureifmachung
Unternehmensverwaltung	Unternehmensverwaltung
Fenstern	Fenster
Matches	Match
Handelsgesesllschaft	Handelsgesesllschaft
Weise	Weise
Grundstücken	Grundstück
wissenschaftlichen	wissenschaftlich
Neubiberg	Neubiberg
Seminare	Seminar
Elektronik	Elektronik
308D	308D
Stephen	Stephen
Anlagetechnik	Anlagetechnik
Handelsgesellschaft	Handelsgesellschaft
Pieper	Pieper
Unterhaltungsautomaten	Unterhaltungsautomat
basierenden	basierend
Gumlich	Gumlich
Medczinski	Medczinski
realisiert	realisieren
Autohaus	Autohaus
Techniker	Techniker
Hardenberg	Hardenberg
Stiftung	Stiftung
Ludger	Ludger
HDF	HDF
Installationen	Installation
Möbius	Möbius
Telter	Telter
Brand	Brand
Semlin	Semlin
Prieros	Prieros
Bianka	Bianka
Mediensystemen	Mediensystem
Bilanzgesetz	Bilanzgesetz
spätere	spät
Team	Team
Füllmann	Füllmann
Corporate	Corporate
PLZ	PLZ
Aufschaltung	Aufschaltung
Personenbeförderung	Personenbeförderung
Entwicklungsbüros	Entwicklungsbüro
Übergabe	Übergabe
dem	d
Heinelt	Heinelt
logistischen	logistisch
Seeheim	Seeheim
Niederdränk	Niederdränk
Andrey	Andrey
Borkwalde	Borkwalde
Nachweises	Nachweis
Praktika	Praktikum
Lebens	Leben
Containerdienstleistungen	Containerdienstleistungen
nachstehend	nachstehend
Mutterkühen	Mutterkuh
Telekommunikations	Telekommunikations
Gawel	Gawel
Filmhandel	Filmhandel
SN	SN
Serviceangeboten	Serviceangeboten
Agenturtätigkeit	Agenturtätigkeit
Offene_Handelsgesellschaft	Offene_Handelsgesellschaft
Krallemann	Krallemann
Fachhandel	Fachhandel
Metallbearbeitung	Metallbearbeitung
Mitglieder	Mitglied
angeschlossener	angeschlossen
Tauchreisen	Tauchreisen
Rekultivierung	Rekultivierung
wurden	werden
Estland	Estland
Dip	Dip
Hochbaus	Hochbau
Weber	Weber
Grundig	Grundig
Importieren	Importieren
im	im
Mochau	Mochau
Ausbaugewerbe	Ausbaugewerbe
Verschmelzungsvertrag	Verschmelzungsvertrag
Sanitär	sanitär
Großraum	Großraum
Bethge	Bethge
unmittelbar	unmittelbar
gewerblicher	gewerblich
gesundheitstechnischer	gesundheitstechnischer
Kunststoffrohrsystemen	Kunststoffrohrsystemen
B.V	B.V
Stolle	Stolle
Ränk	Ränk
Verbrauchserfassungsmeßgeräten	Verbrauchserfassungsmeßgeräten
Nutz	Nutz
Köbinger	Köbinger
Kapitalanlagen	Kapitalanlage
Ergänzungsschulen	Ergänzungsschulen
Betonbauer	Betonbauer
Rüstungsaltlasten	Rüstungsaltlasten
Sportes	Sport
Salvatore	Salvatore
Veer	Veer
LDF	LDF
Außenbereich	Außenbereich
Gewinnung	Gewinnung
Gewerke	Gewerke
Umweltprojekte	Umweltprojekt
Boots	Boot
Informationsverarbeitung	Informationsverarbeitung
Medienstadt	Medienstadt
Stimming	Stimming
Institutionen	Institution
f	F
Wasserinstallationen	Wasserinstallation
Fetzer	Fetzer
Vermögensverwaltung	Vermögensverwaltung
haustechnischen	haustechnisch
Gewerbeordnung	Gewerbeordnung
gewerblich	gewerblich
WEGOS	WEGOS
Sägewerks	Sägewerk
Monaten	Monat
Bauwerke	Bauwerk
Urstomtal	Urstomtal
Treppenbauarbeiten	Treppenbauarbeiten
drahtlosen	drahtlos
Sportler	Sportler
Freund	Freund
Instandhaltung	Instandhaltung
Olaf	Olaf
Nahrungsmitteln	Nahrungsmitteln
Datenkabelbereich	Datenkabelbereich
sontigen	sontigen
Schlanert	Schlanert
Spielfilme	Spielfilm
Helena	Helena
Softwareproblemen	Softwareproblemen
Pharmazeutika	Pharmazeutika
Vietze	Vietze
Wach	wach
Entertainment	Entertainment
Blutkonzentraten	Blutkonzentraten
Schütz	Schütz
Nutzflächen	Nutzfläche
energietechnischen	energietechnisch
unterstützen	unterstützen
Vorstandes	Vorstand
Nadelgehölzen	Nadelgehölz
Rohland	Rohland
Anteilsscheinen	Anteilsscheinen
ff.	ff.
Geschäftsführungsaufgaben	Geschäftsführungsaufgaben
Zuteilung	Zuteilung
RB	RB
Asphaltmischgut	Asphaltmischgut
Jacobitz	Jacobitz
Spiel	Spiel
Fördertechnik	Fördertechnik
Buchholz	Buchholz
Baugruppen	Baugruppe
Durchführungen	Durchführung
Dachdeckerleistungen	Dachdeckerleistungen
Programmierarbeiten	Programmierarbeiten
Adrien	Adrien
erlaubnispflichtige	erlaubnispflichtig
Eisenwaren	Eisenware
Betreuungs	Betreuungs
Inhalts	Inhalt
Manfred	Manfred
Tennisprofis	Tennisprofi
Blesse	Blesse
Meisterberuf	Meisterberuf
Hirt	Hirt
Dienstleistungsmanagement	Dienstleistungsmanagement
ist	sein
Box	Box
Schuhe	Schuh
Maik	Maik
Gastronomie	Gastronomie
Fertigmöbeln	Fertigmöbeln
Projektsteuerung	Projektsteuerung
Landschaft	Landschaft
Skrzipczyk	Skrzipczyk
Transportdiensten	Transportdienst
Wechselbrücken	Wechselbrücke
Marktplätze	Marktplatz
Reinigungsdienste	Reinigungsdienst
TERRANO	TERRANO
Schuhmann	Schuhmann
Beteiligungskonzepten	Beteiligungskonzepten
Schlosserei	Schlosserei
Munition	Munition
Fassadenreinigung	Fassadenreinigung
Emirate	Emirat
Bloch	Bloch
System	System
Anbietern	Anbieter
Installations	Installations
Altes	Altes
Abstimmung	Abstimmung
Konfektion	Konfektion
Wetzel	Wetzel
Bauorganisation	Bauorganisation
tiefgekühlten	tiefgekühlt
Kommunikationsforschung	Kommunikationsforschung
befassen	befassen
herabsetzung	Herabsetzung
Bauträgerleistungen	Bauträgerleistungen
Systementwicklung	Systementwicklung
F	F
Behandlungs	Behandlungs
ADVISA	ADVISA
Verlages	Verlag
anderen	ander
welche	welch
Gegenstandes	Gegenstand
Gartenbau	Gartenbau
Treffurt	Treffurt
Comecon	Comecon
Telefonanlagen	Telefonanlage
betreiben	betreiben
Szerwinski	Szerwinski
Grundstückserwerb	Grundstückserwerb
Holger	Holger
Poredda	Poredda
Dempewolf	Dempewolf
Altlasten	Altlasten
Einzelprokuristin	Einzelprokuristin
Elektromontage	Elektromontage
Rauh	rauh
Flachdächer	Flachdach
FORIS	FORIS
Waschke	Waschke
Bauplanung	Bauplanung
Richards	Richards
Druckerei	Druckerei
Kommanditistin	Kommanditistin
Kodal	Kodal
Diplombiologin	Diplombiologin
Fertigelementen	Fertigelementen
Digital	digital
Badmöbeln	Badmöbeln
Lizenzvergabeverfahren	Lizenzvergabeverfahren
Havelland	Havelland
Tennisarms	Tennisarms
Hösl	Hösl
Gotha	Gotha
gem.	gem.
Augsburg	Augsburg
Bädern	Bad
Ziegler	Ziegler
ausländische	ausländisch
Reinigungsservice	Reinigungsservice
Dipl.-Betriebswirt	Dipl.-Betriebswirt
Außenausstattung	Außenausstattung
Lüdersdorf	Lüdersdorf
Jeserig	Jeserig
Iserlohn	Iserlohn
sonstigem	sonstig
Straßenbauarbeiten	Straßenbauarbeiten
LBB	LBB
Fürstenwalde	Fürstenwald
Filmproduktion	Filmproduktion
Regine	Regine
Be	Be
Telekommunikation	Telekommunikation
Frederic	Frederic
teilweisen	teilweise
Kommunikationsberatung	Kommunikationsberatung
medienwirtschaftlichen	medienwirtschaftlich
Industriekauffrau	Industriekauffrau
Bereiches	Bereich
Vorhaben	Vorhaben
Schulz	Schulz
Pigard	Pigard
Infrastruktur	Infrastruktur
extrakorporale	extrakorporale
Schutz	Schutz
Bilanzgewinn	Bilanzgewinn
hydro	hydro
Softwarenprogrammen	Softwarenprogrammen
Liquidation	Liquidation
Brandenburg	Brandenburg
sanitärtechnischen	sanitärtechnischen
Entsorgungsträger	Entsorgungsträger
Bröcker	Bröcker
Speisen	Speisen
jedweder	jedwed
raumlufttechnischen	raumlufttechnischen
Metz	Metz
Wärme	Wärme
Salzuflen	Salzuflen
Sylwia	Sylwia
Ludyga	Ludyga
Stürmlinger	Stürmlinger
Gebel	Gebel
Paris	Paris
Herren	Herr
Erd	Erd
Koproduktionen	Koproduktion
EDS	EDS
Schilder	Schild
Sparkasse	Sparkasse
ebenfalls	ebenfalls
Hohenferchesar	Hohenferchesar
Baumaschinenvermietung	Baumaschinenvermietung
Dokumentation	Dokumentation
Kabeln	Kabeln
Lahme	Lahme
Fernsehserien	Fernsehserie
Geschäftsführerin	Geschäftsführerin
Grundsatzfragen	Grundsatzfragen
Abschnitt	Abschnitt
Brückner	Brückner
Siegfried	Siegfried
Neidick	Neidick
vorbezeichneten	vorbezeichnet
Rödelheim	Rödelheim
Genehmigungspflicht	Genehmigungspflicht
genormten	genormt
Erwerbern	Erwerber
versorgungstechnische	versorgungstechnische
Paritätischen	Paritätische
nachfolgend	nachfolgend
Büroreinigung	Büroreinigung
Krinks	Krinks
Bauwerksteilen	Bauwerksteilen
Eckendorf	Eckendorf
Wirtschaftsunternehmen	Wirtschaftsunternehmen
Prignitz	Prignitz
wirtschaftlichen	wirtschaftlich
Seyerlein	Seyerlein
Wasserbehandlung	Wasserbehandlung
Mittermaier	Mittermaier
Fallis	Fallis
bespielter	bespielt
Sprachtelefondienst	Sprachtelefondienst
Multimediasysteme	Multimediasysteme
Pferdeboxen	Pferdeboxen
Kraftfahrzeugwesen	Kraftfahrzeugwesen
solche	solch
Versorgungs	Versorgungs
Bauindustrie	Bauindustrie
USA	USA
lassen	lassen
Kulturhaus	Kulturhaus
Häuserbau	Häuserbau
Ident	Ident
journalistischer	journalistisch
Paschy	Paschy
Münster	Münster
Chlor	Chlor
Schulze	Schulze
mobilen	mobil
dazugehöriger	dazugehörig
munitionsbelasteter	munitionsbelasteter
Relations	Relations
verlangen	verlangen
ergänzt	ergänzen
kompletter	komplett
digitaler	digital
derartige	derartig
Einsatz	Einsatz
Gastronomieobjekten	Gastronomieobjekten
Patanyi	Patanyi
Rohrleitungsanlagen	Rohrleitungsanlagen
Wiederherstellung	Wiederherstellung
Schmucker	Schmucker
Kondla	Kondla
Holtkamp	Holtkamp
analoger	analog
Wenzel	Wenzel
Danders	Danders
Speise	Speise
entwicklung	Entwicklung
Auftragsvermittlung	Auftragsvermittlung
Stahlbetonbauer	Stahlbetonbauer
Saarmund	Saarmund
Dritten	Dritte
Versandhandels	Versandhandel
englischem	englisch
Ingenius	Ingenius
Wittmannsdorf	Wittmannsdorf
Mittenwalde	Mittenwald
HRA	HRA
Hallenbau	Hallenbau
vorhandener	vorhanden
Hermel	Hermel
Steuer	Steuer
Sous	Sou
Teileigentum	Teileigentum
Oder	oder
unbebaut	unbebaut
Y.	Y.
Jedes	jed
Worbs	Worb
Schnarr	Schnarr
Industriebedarf	Industriebedarf
Blutes	Blut
Teichbau	Teichbau
Produktvertretungen	Produktvertretungen
Holzbearbeitungswerkstatt	Holzbearbeitungswerkstatt
desweiteren	desweiteren
Lüftung	Lüftung
Buchführungsaufgaben	Buchführungsaufgaben
EnergyCom	EnergyCom
Beschränkungemn	Beschränkungemn
Perl	Perl
Thermalbad	Thermalbad
Linien	Linie
Blechen	Blechen
Werksnah	Werksnah
Fertigbau	Fertigbau
Solutions	Solutions
Everswinkel	Everswinkel
Maschinenschachtungen	Maschinenschachtungen
business	business
Wenzlow	Wenzlow
Bundeswehr	Bundeswehr
Bernard	Bernard
Kramer	Kramer
Treuhänder	Treuhänder
Gebrauchsgütern	Gebrauchsgut
Bornstädt	Bornstädt
Ergebnisabführungs	Ergebnisabführungs
Heizungsanlagen	Heizungsanlage
Eric	Eric
Kraftfutter	Kraftfutter
Büros	Büro
Hausfrauenart	Hausfrauenart
IPMG	IPMG
Nr.	Nr.
Pflanzenöles	Pflanzenöles
Gebäudesanierung	Gebäudesanierung
WLL	WLL
Coenraad	Coenraad
Flügen	Flug
Vermakelung	Vermakelung
Spaltungsplan	Spaltungsplan
individuellem	individuell
Rollläden	Rollläden
Würselen	Würselen
Weißert	Weißert
Löwendorf	Löwendorf
selben	selb
Fernsehprogramme	Fernsehprogramm
Fertighaus	Fertighaus
Bildung	Bildung
Methoden	Methode
Pfeffer	Pfeffer
Gemüse	Gemüse
Marek	Marek
Baulichkeiten	Baulichkeit
Feige	Feige
usw	usw
PKW	Pkw
Schönes	Schöne
Langenlipsdorf	Langenlipsdorf
Planungen	Planung
Massivhaus	Massivhaus
Hierzu	hierzu
oben	oben
Kommunikationsdiensten	Kommunikationsdiensten
Zwecke	Zwecke
Bereich	Bereich
Klargestellt	klarstellen
betriebswirtschaftlichen	betriebswirtschaftlich
alles	alle
Aus	Aus
Infolge	infolge
Gestalten	Gestalten
HUMANITAS	HUMANITAS
erneute	erneut
Programms	Programm
Unternehmensdienstleistungen	Unternehmensdienstleistungen
Torsten	Torsten
Handwerk	Handwerk
Klamann	Klamann
Achim	Achim
pachten	pachten
Geschäftszweckes	Geschäftszweckes
Bauunternehmung	Bauunternehmung
Thesen	Thesen
schließt	schließen
Erdmann	Erdmann
Ganzes	Ganze
wissenschaftlicher	wissenschaftlich
nachhaltige	nachhaltig
Kotzur	Kotzur
dosiertechnischen	dosiertechnischen
Scholte	Scholte
Hildmann	Hildmann
wurde	werden
Anwendungstechnik	Anwendungstechnik
Genugten	Genugten
Danneberg	Danneberg
Linoleum	Linoleum
Steuerfachgehilfin	Steuerfachgehilfin
LUMAX	LUMAX
Sylvia	Sylvia
Strom	Strom
HGB	HGB
Generierung	Generierung
Immobilienfinanzierungen	Immobilienfinanzierungen
umwelttechnischen	umwelttechnisch
Transportunternehmens	Transportunternehmen
Vermögen	Vermögen
Holzdesign	Holzdesign
mechanischen	mechanisch
vor	vor
angegebenen	angegeben
Schöneiche	Schöneiche
Zurschaustellung	Zurschaustellung
Wemken	Wemken
Kalendern	Kalender
Küchler	Küchler
Paretz	Paretz
Gleisoberbautechnik	Gleisoberbautechnik
Betriebstechnik	Betriebstechnik
Beschluß	Beschluß
Geußnitz	Geußnitz
Geschäftsvorbauten	Geschäftsvorbauten
Henri	Henri
Leichtmetallgerüsten	Leichtmetallgerüsten
Neubauvorhaben	Neubauvorhaben
Truppel	Truppel
Straßengüterverkehr	Straßengüterverkehr
grundstücksgleichen	grundstücksgleichen
Ilmari	Ilmari
erteilt	erteilen
Leinfelden	Leinfelden
hieraus	hieraus
Romstedt	Romstedt
Musikalien	Musikalien
Anhängern	Anhänger
MDF	MDF
Heizungsinstallateurhandwerksbetrieb	Heizungsinstallateurhandwerksbetrieb
d	D
Hernfried	Hernfried
Fußbodenlegearbeiten	Fußbodenlegearbeiten
Private	privat
Beschuß	Beschuß
Gesellschafter	Gesellschafter
Amts	Amt
Thinius	Thinius
Prag	Prag
ganzer	ganz
stehende	stehend
Aspekte	Aspekt
AMRO	AMRO
Steuerberaterin	Steuerberaterin
übernehmer	Übernehmer
Trainingstherapie	Trainingstherapie
Rückbau	Rückbau
Koerber	Koerber
Korb	Korb
Solarium	Solarium
Olivera	Olivera
Technologietransfer	Technologietransfer
Jachtanlagen	Jachtanlagen
redaktionell	redaktionell
städtebaulichen	städtebaulich
Belltrans	Belltrans
Analysegeräten	Analysegerät
Bauträgergeschäfte	Bauträgergeschäfte
grenzender	grenzender
Reinhardt	Reinhardt
Valerie	Valerie
zeitgleich	zeitgleich
Werbeartikeln	Werbeartikel
EB	EB
Serviceleistungen	Serviceleistung
aus	aus
Souvenirs	Souvenir
Fassadenarbeiten	Fassadenarbeiten
Bauklempnerei	Bauklempnerei
behördlichen	behördlich
Eugenius	Eugenius
inländischen	inländisch
Wohnungs	Wohnungs
Göhs	Göhs
Bundes	Bund
Büromöbel	Büromöbel
Herbst	Herbst
Kräutern	Kraut
Geschäftsverkehr	Geschäftsverkehr
alter	alt
Meßgeräte	Meßgerät
Einschluss	Einschluss
Baumaterialien	Baumaterial
steuerbegünstigten	steuerbegünstigt
jeweils	jeweils
Frenz	Frenz
Gewerbepark	Gewerbepark
Herrmann	Herrmann
Yildiz	Yildiz
Tanja	Tanja
Grundstücksentwicklung	Grundstücksentwicklung
Unternehmensgegenstandes	Unternehmensgegenstandes
Selbständigen	Selbständige
Dahme	Dahme
Voermanek	Voermanek
Heizungsbauer	Heizungsbauer
Industriemineralien	Industriemineralien
Hohdorf	Hohdorf
Gesamtprokuristin	Gesamtprokuristin
Zimmermann	Zimmermann
Rosenthal	Rosenthal
Baustoff	Baustoff
Sekundärrohstoffen	Sekundärrohstoff
Gekmann	Gekmann
Videoproduktionen	Videoproduktion
Genthin	Genthin
Versorgungstechnik	Versorgungstechnik
Sportanlagen	Sportanlage
Glas	Glas
Verfahren	Verfahren
Utz	Utz
entweder	entweder
keramischem	keramischem
Ohst	Ohst
EUR	EUR
Konkursen	Konkurs
Schriften	Schrift
Hochmuth	Hochmuth
Ablaufes	Ablauf
Ingenieurbüro	Ingenieurbüro
DM	DM
entwickelt	entwickeln
Mieten	Mieten
ABIS	ABIS
grundstücksgleiche	grundstücksgleich
Industriemaschinen	Industriemaschine
Fuhrunternehmens	Fuhrunternehmen
Orga	Orga
international	international
Stehling	Stehling
verschmolzenen	verschmolzen
Moser	mosern
Millennium	Millennium
D	D
Konzepte	Konzept
Schneyer	Schneyer
Außenanlagenbau	Außenanlagenbau
Chemie	Chemie
Grafik	Grafik
Baureparaturen	Baureparatur
Tourismusgewerbes	Tourismusgewerbe
Tagungs	Tagungs
Karlsruhe	Karlsruhe
Verlegung	Verlegung
Horn	Horn
Yundou	Yundou
eingereichten	eingereicht
Unternehmensführung	Unternehmensführung
Alleingesellschafterin	Alleingesellschafterin
Münchow	Münchow
Grabowski	Grabowski
Kahstein	Kahstein
Bausparverträgen	Bausparvertrag
Sujata	Sujata
Baugesellschaft	Baugesellschaft
Tapezierarbeiten	Tapezierarbeiten
Weiterer	weit
KrW	KrW
Kapitalgesellschaft	Kapitalgesellschaft
Gastechnik	Gastechnik
NEK	NEK
Heilkunde	Heilkunde
Tag	Tag
Rehabilitationseinrichtungen	Rehabilitationseinrichtung
Reizig	Reizig
Gerüsten	Gerüst
Sicherheitsdienste	Sicherheitsdienst
Freizeitimmobilien	Freizeitimmobilien
Briesenick	Briesenick
Tischlereiarbeiten	Tischlereiarbeiten
Schankwirtschaft	Schankwirtschaft
Sebastian	Sebastian
Visintin	Visintin
Call	Call
Schütte	schütten
Anpflanzungen	Anpflanzung
Instandsetzungsprojekten	Instandsetzungsprojekten
staatlichen	staatlich
allein	allein
Sverre	Sverre
Spevak	Spevak
bzw.	bzw.
Schöbendorf	Schöbendorf
Dreßel	Dreßel
Friedrichspark	Friedrichspark
Vervielfältigungsträgern	Vervielfältigungsträgern
Mader	Mader
ohne	ohne
Br.	Br.
Hochbaubetrieb	Hochbaubetrieb
anfallen	anfallen
Kunsttransporte	Kunsttransporte
Fertigbauteilen	Fertigbauteilen
Kraftfahrzeugreparaturarbeiten	Kraftfahrzeugreparaturarbeiten
Vorstehendem	Vorstehendem
Zwickau	Zwickau
Bootsverleih	Bootsverleih
Center	Center
Rechenzentren	Rechenzentrum
Ventile	Ventil
Gelsenkirchen	Gelsenkirchen
Existenzgründung	Existenzgründung
treuhänderischer	treuhänderischer
Instrumente	Instrument
Bargfried	Bargfried
Truschkowski	Truschkowski
Namen	Name
einen	ein
Sportartikel	Sportartikel
Räume	Raum
Lars	Lars
Horner	Horner
Haushalte	Haushalt
Nutzungsarbeiten	Nutzungsarbeiten
Sygenstein	Sygenstein
Arnold	Arnold
Relation	Relation
persönlichen	persönlich
Schellmann	Schellmann
Tetsch	Tetsch
sanitärtechnische	sanitärtechnische
Seefahrzeugen	Seefahrzeugen
Lange	Lange
Bendig	Bendig
Abdichtungstechnik	Abdichtungstechnik
Jacobs	Jacobs
Parks	Park
Zentrums	Zentrum
Camlott	Camlott
Jüterbog	Jüterbog
Radmila	Radmila
Reinsdorf	Reinsdorf
Matthes	Matthes
Bestätigungsvermerken	Bestätigungsvermerken
Freizeitkomplexes	Freizeitkomplexes
Blazer	Blazer
Gründungskosten	Gründungskosten
Handelstätigkeiten	Handelstätigkeit
Pixken	Pixken
Gerken	Gerken
Jugend	Jugend
Taufkirchen	Taufkirche
Schlänitzsee	Schlänitzsee
Murray	Murray
Spezialleitungen	Spezialleitungen
corporate	corporate
Fähigkeiten	Fähigkeit
Wauer	Wauer
Wiczynski	Wiczynski
Kamran	Kamran
Satzungszweck	Satzungszweck
Aufzeichnung	Aufzeichnung
Rösrath	Rösrath
Gesetzliche	Gesetzliche
Gesellschaft	Gesellschaft
Heiko	Heiko
produziert	produzieren
Pufahl	Pufahl
Welsickendorf	Welsickendorf
Kapitalbeteiligungen	Kapitalbeteiligung
Umwandlung	Umwandlung
Kehrarbeiten	Kehrarbeiten
verlegt	verlegen
Ebel	Ebel
Informationen	Information
Architekten	Architekt
Lady	Lady
Württemberg	Württemberg
Kenia	Kenia
Andrea	Andrea
Unterhaltsreinigung	Unterhaltsreinigung
Niederlassungen	Niederlassung
Hellmich	Hellmich
Verlegen	Verlegen
Ticket	Ticket
Knut	Knut
Fred	Fred
Wannen	Wanne
Garten	Garten
Armaturen	Armatur
Karen	Karen
Serien	Serie
Berufserfahrung	Berufserfahrung
Fahrzeugen	Fahrzeugen
angewandte	angewandt
Wohn	wohnen
Homburg	Homburg
Schaukämpfen	Schaukämpfen
Vertriebsstelle	Vertriebsstelle
Programmierung	Programmierung
Irene	Irene
Landschaften	Landschaft
Kanalsanierungs	Kanalsanierungs
Becher	Becher
Entwässerungsbau	Entwässerungsbau
Wässern	Wässern
Gesellschafterin	Gesellschafterin
Baubetreuungs	Baubetreuungs
Ruckes	Ruckes
Betreibens	Betreiben
übrigen	übrig
technischem	technisch
Wollmer	Wollmer
Biomedizin	Biomedizin
Chemieerzeugnissen	Chemieerzeugnissen
errichtet	errichten
Systemtechnik	Systemtechnik
Einrichtung	Einrichtung
Rahn	Rahn
Waldkolonie	Waldkolonie
Kino	Kino
Ladislav	Ladislav
Gelegenheitsverkehr	Gelegenheitsverkehr
Bautrocknungsgewerbe	Bautrocknungsgewerbe
CH	CH
verschiedener	verschieden
Bodenverlegung	Bodenverlegung
Gebäudeleit	Gebäudeleit
Dentaltechnik	Dentaltechnik
Außenhandel	Außenhandel
Wustermark	Wustermark
Donner	Donner
Freianlagen	Freianlage
bebauter	bebauter
Vermögensverwaltungs	Vermögensverwaltungs
außen	außen
Elektroarbeiten	Elektroarbeiten
S	S
Fliesenlegerarbeiten	Fliesenlegerarbeiten
Beplanung	Beplanung
Zeesen	Zeese
Pfeufer	Pfeufer
anschließende	anschließend
Energiedienstleistungen	Energiedienstleistung
Kaufleuten	Kaufleute
Schülerbeförderung	Schülerbeförderung
Georg	Georg
Flöha	Flöha
übt	üben
Adolph	Adolph
Wohneinrichtungen	Wohneinrichtung
Realteilung	Realteilung
bestehender	bestehend
professionelle	professionell
Abwicklung	Abwicklung
Ausleihdienstes	Ausleihdienstes
Senzke	Senzke
Reparaturen	Reparatur
verbrauchsabhängiger	verbrauchsabhängiger
Ohrt	Ohrt
diesen	dies
Holzernte	Holzernte
Margit	Margit
Rydz	Rydz
mehr	mehr
BMW	BMW
Außenpflege	Außenpflege
bringt	bringen
gesetzlich	gesetzlich
Personenhandels	Personenhandels
visuellen	visuell
Möse	Möse
Finanz	Finanz
Dagmar	Dagmar
Schönborn	Schönborn
bis	bis
Unterrichtung	Unterrichtung
Hauptzweck	Hauptzweck
Pribilla	Pribilla
umgerechnet	umrechnen
Papiererzeugnissen	Papiererzeugnissen
berät	beraten
Preßwerkzeugen	Preßwerkzeugen
Verwertung	Verwertung
Neubau	Neubau
müssen	müssen
Grundstücksakquisition	Grundstücksakquisition
Unterschied	Unterschied
Wissensindustrie	Wissensindustrie
Klatt	Klatt
Kleemann	Kleemann
Innen	innen
Videopostproduktion	Videopostproduktion
Bauträgertätigkeit	Bauträgertätigkeit
Kemnitz	Kemnitz
Prüfungen	Prüfung
Distributionsprojekten	Distributionsprojekten
Hanseatische	Hanseatische
letzter	letzt
auszubilden	ausbilden
Veranstalter	Veranstalter
Wladimir	Wladimir
Internationales	Internationale
Hauspflegearbeiten	Hauspflegearbeiten
Dimde	Dimde
Manthei	Manthei
Ausbauelementen	Ausbauelementen
Anlagenrevisionen	Anlagenrevisionen
commerce	commerce
Wattenbek	Wattenbek
Seddiner	Seddiner
Programme	Programm
ausgewählten	ausgewählt
Trainern	Trainer
Thomas	Thomas
Endgeräten	Endgerät
Werkzeugen	Werkzeugen
Ehlert	Ehlert
Touristische	touristisch
Kommunen	Kommune
BE	BE
anlagen	anliegen
welcher	welch
Marina	Marina
Getränken	Getränk
Ausrichtung	Ausrichtung
Vorarbeiten	Vorarbeiten
Gewerbeobjekten	Gewerbeobjekt
Pirmasens	Pirmasens
Krautwald	Krautwald
Branche	Branche
Fietz	Fietz
Bauträgerschaft	Bauträgerschaft
Tiefbauarbeiten	Tiefbauarbeiten
Wesseling	Wesseling
Holzkonstruktionen	Holzkonstruktion
Gotthelf	Gotthelf
Walbrach	Walbrach
Strehlow	Strehlow
augusta	augusta
Wolfgang	Wolfgang
Ton	Ton
Schrott	Schrott
Gewerbebetrieben	Gewerbebetrieb
neu	neu
Passiva	Passiv
Biewald	Biewald
Kindern	Kind
Glau	Glau
Tierhaltung	Tierhaltung
Lizenzen	Lizenz
Roman	Roman
Thieke	Thieke
Ferner	fern
Hornig	Hornig
ABN	ABN
Annahmestelle	Annahmestelle
Schönwalde	Schönwald
Korrosionsschutz	Korrosionsschutz
verfahrenstechnische	verfahrenstechnisch
Installateurarbeiten	Installateurarbeiten
Handelshäusern	Handelshaus
ordentlichen	ordentlich
AüG	AüG
Repräsentanzen	Repräsentanz
Gummiböden	Gummiböden
Freiburg	Freiburg
Nebenarbeiten	Nebenarbeiten
Urheber	Urheber
Frankreich	Frankreich
Theuring	Theuring
Erzeugnissen	Erzeugnis
Kariger	Kariger
Mewis	Mewis
Kubin	Kubin
Hochtechnologiesicherheitsanlagen	Hochtechnologiesicherheitsanlagen
Bauhandwerks	Bauhandwerk
Bauüberwachung	Bauüberwachung
Dentallabors	Dentallabor
Forschungsaufträgen	Forschungsauftrag
POLYPROJEKTA	POLYPROJEKTA
Dekorationsbau	Dekorationsbau
Zimmerei	Zimmerei
Ausbau	Ausbau
Steuern	Steuern
sowie	sowie
Eigentumsform	Eigentumsform
verwandtem	verwandt
Janke	Janke
Säcken	Sack
Sackmann	Sackmann
Lagerung	Lagerung
Puppe	Puppe
bisherige	bisherig
Gangur	Gangur
Zucht	Zucht
Holzendorf	Holzendorf
Mailing	Mailing
Versicherungs	Versicherungs
Radlager	Radlager
Bagger	Bagger
Dipl.Kaufmann	Dipl.Kaufmann
Trockenarbeiten	Trockenarbeiten
sozialer	sozial
Ausübung	Ausübung
Auslandsmärkte	Auslandsmarkt
Jühnsdorf	Jühnsdorf
Golf	Golf
Teilnehmeranschlüssen	Teilnehmeranschlüssen
derer	d
SprengG	SprengG
Meißner	Meißner
Umzugsnahverkehr	Umzugsnahverkehr
Spezialarbeiten	Spezialarbeiten
Forschungstätigkeit	Forschungstätigkeit
Großziethen	Großziethen
Jobbörsen	Jobbörsen
vorwiegend	vorwiegend
Großkopf	Großkopf
branchen	Branche
Teichmann	Teichmann
Willnat	Willnat
Ausscheiden	Ausscheiden
Freizeitprojektierungen	Freizeitprojektierungen
Entwurf	Entwurf
haustechnischer	haustechnischer
Therapie	Therapie
administrative	administrativ
Sicherung	Sicherung
Klaas	Klaas
Senioren	Senioren
Schlösser	Schloß
chemischer	chemisch
Arbeit	Arbeit
Büroservicediensten	Büroservicediensten
Kommunikationstechnik	Kommunikationstechnik
ausgeschlossen	ausschließen
Finanzierung	Finanzierung
Softwareentwicklung	Softwareentwicklung
Maria	Maria
Krenz	Krenz
stellvertretendes	stellvertretend
Übertragung	Übertragung
Hübner	Hübner
Fahrzeugscheiben	Fahrzeugscheiben
zusammenhängender	zusammenhängend
Asbestsanierung	Asbestsanierung
Heinicke	Heinicke
Medienprodukten	Medienprodukt
bringen	bringen
Schwimmbadwasseraufbereitungsanlagen	Schwimmbadwasseraufbereitungsanlagen
biologischer	biologisch
Mietwohnungsbau	Mietwohnungsbau
Affeld	Affeld
professionellen	professionell
Studienpädagogik	Studienpädagogik
verwenden	verwenden
Einzlvertretungsbefugnis	Einzlvertretungsbefugnis
Mutterkuh	Mutterkuh
Weiss	Weiss
Plasma	Plasma
Datenaufzeichnungssystemen	Datenaufzeichnungssystemen
Jahne	Jahne
Informatik	Informatik
Schulung	Schulung
Gellesch	Gellesch
Abfallstoffen	Abfallstoff
Anspruch	Anspruch
Schandog	Schandog
elektronischen	elektronisch
Hubarbeitsbühnen	Hubarbeitsbühnen
Vor	vor
alleiniger	alleinig
Kauf	Kauf
Handelsware	Handelsware
Klaus	Klaus
Vorstandsmitgliedern	Vorstandsmitglied
Egbert	Egbert
Rohholz	Rohholz
René	René
Bauhauptgewerbe	Bauhauptgewerbe
beauftragt	beauftragen
Nachrichten	Nachricht
Ziel	Ziel
Technologie	Technologie
Kundendienstarbeiten	Kundendienstarbeiten
Betriebsgesellschaft	Betriebsgesellschaft
Wettbewerbs	Wettbewerb
Bauelemente	Bauelement
Claus	Claus
Splitte	Splitte
Callcenters	Callcenters
Ferdinand	Ferdinand
Beirates	Beirat
Neugründung	Neugründung
International	International
Kranz	Kranz
Einfamilienhäuser	Einfamilienhaus
Schewtschik	Schewtschik
Grundstück	Grundstück
Anett	Anett
Krankenhausreinigung	Krankenhausreinigung
wirtschaftlicher	wirtschaftlich
eingetreten	eintreten
Hinzuziehung	Hinzuziehung
ähnlichem	ähnlich
Cvetanovic	Cvetanovic
Barre	Barre
Eingehen	Eingehen
Baesel	Baesel
ausländischen	ausländisch
Infra	Infra
Joachim	Joachim
Handwerksbetriebe	Handwerksbetrieb
Fliesenlegerhandwerks	Fliesenlegerhandwerks
Gießerei	Gießerei
Heilpraktikerin	Heilpraktikerin
Viersen	Viersen
Hardy	Hardy
erreicht	erreichen
ausgeübt	ausüben
Objektbebauung	Objektbebauung
Werbeberatung	Werbeberatung
Baubeschlägen	Baubeschlägen
Ebbers	Ebbers
Kanitz	Kanitz
ausgeschieden	ausscheiden
Heribert	Heribert
Duscha	Duscha
Telekommunikationsdienstleistungen	Telekommunikationsdienstleistung
Rendelmann	Rendelmann
Golfplatz	Golfplatz
Tennistraining	Tennistraining
PR	PR
neuesten	neu
Sponsorensuche	Sponsorensuche
Baubedarfsartikeln	Baubedarfsartikeln
Marktes	Markt
Umrechnungskurs	Umrechnungskurs
WEG	weg
Wohlfahrtsverbandes	Wohlfahrtsverband
Immobilie	Immobilie
Sportstätten	Sportstätte
Erreichung	Erreichung
Weigt	Weigt
virtueller	virtuell
Wirtschaftsberatung	Wirtschaftsberatung
Ingo	Ingo
Jesus	Jesus
Seddin	Seddin
Hentschel	Hentschel
Brandenstein	Brandenstein
lt.	lt.
Pritzerbe	Pritzerbe
gerichtete	gerichtet
Auftrag	Auftrag
Helge	Helge
Mülheim	Mülheim
Schipper	Schipper
integrative	integrativ
Rohleder	Rohleder
Mittelmark	Mittelmark
Rechtsstellung	Rechtsstellung
Bauleistungen	Bauleistung
Biedermann	Biedermann
Empire	Empire
Dobbrikow	Dobbrikow
Gesellschafterbeschlüsse	Gesellschafterbeschlüsse
Silhavy	Silhavy
Hofer	Hofer
Jentsch	Jentsch
Smokdunowski	Smokdunowski
Netzwerkslösungen	Netzwerkslösungen
herstellen	herstellen
Buschow	Buschow
medienwissenschaftlichen	medienwissenschaftlich
Rhodus	Rhodus
Schweiz	Schweiz
Mai	Mai
Dietlind	Dietlind
Ilja	Ilja
Freienthal	Freienthal
Schutt	Schutt
Komplementärs	Komplementärs
nachfolgenden	nachfolgend
Wegen	wegen
grundstückgleiche	grundstückgleiche
geschlossenen	geschlossen
Abbruchholz	Abbruchholz
Skärke	Skärke
Breitenwischer	Breitenwischer
Systemlösungen	Systemlösung
Henrik	Henrik
Freizeitanlage	Freizeitanlage
Verschmelzungsvertrages	Verschmelzungsvertrages
Rieben	reiben
Brigachtal	Brigachtal
Ingelheim	Ingelheim
Göhlsdorf	Göhlsdorf
Fachkräften	Fachkraft
Slusar	Slusar
elektrischer	elektrisch
Bauabläufen	Bauabläufen
Höpfner	Höpfner
uneingeschränkt	uneingeschränkt
einzugehen	eingehen
Marion	Marion
Friesoythe	Friesoythe
schulung	Schulung
EDV	EDV
gemeinnützige	gemeinnützig
siebenunddreißigste	siebenunddreißigst
Gaststätten	Gaststätte
Autohandel	Autohandel
Programmteile	Programmteil
Krieger	Krieger
Errichtung	Errichtung
Printing	Printing
Teilerbbaurechte	Teilerbbaurechte
Kraftfahrzeugreparaturen	Kraftfahrzeugreparaturen
Frachtgeschäften	Frachtgeschäften
Anbieter	Anbieter
Wurst	Wurst
Entkernungsarbeiten	Entkernungsarbeiten
BDP	BDP
Wusterwitz	Wusterwitz
Wahrnehmung	Wahrnehmung
Neuenahr	Neuenahr
Verwaltung	Verwaltung
Bestensee	Bestensee
Henning	Henning
Steuerangelegenheiten	Steuerangelegenheit
Ilona	Ilona
Friedrich	Friedrich
vorhabenbezogenen	vorhabenbezogenen
Internat	Internat
Lackiererarbeiten	Lackiererarbeiten
Backwaren	Backware
vollständigen	vollständig
Lacken	Lacken
Renner	Renner
Wilfried	Wilfried
Teils	Teil
Schnarre	Schnarre
Maschinenverleih	Maschinenverleih
Gesellschaftsbeteiligungen	Gesellschaftsbeteiligungen
Kanalreinigungsunternehmens	Kanalreinigungsunternehmens
Freileben	Freileben
Matthäus	Matthäus
vorrangig	vorrangig
Wendt	Wendt
Umzügen	Umzug
folgende	folgend
er	er
Krielow	Krielow
Kapitalanlagegesellschaft	Kapitalanlagegesellschaft
Bareinlagen	Bareinlage
Berufsbild	Berufsbild
marktfähigen	marktfähig
Schlagenthin	Schlagenthin
verwandter	verwandt
Hink	Hink
Reisebüros	Reisebüro
Schwimmbadtechnik	Schwimmbadtechnik
Modernisierung	Modernisierung
Umweltschutzes	Umweltschutz
Rödel	Rödel
Lampentechnik	Lampentechnik
Holzerzeugnissen	Holzerzeugnissen
allgemeinen	allgemein
Betriebskantinen	Betriebskantine
Balaz	Balaz
Gewerbegrundstücken	Gewerbegrundstück
Spitzenmannschaften	Spitzenmannschaft
Holzbau	Holzbau
vertritt	vertreten
Street	Street
Findik	Findik
Sportveranstaltungen	Sportveranstaltung
Brandenburgischen	Brandenburgische
Anlieferung	Anlieferung
Innovative	innovativ
Solartechnik	Solartechnik
Holbeck	Holbeck
Fährwiese	Fährwiese
Wolter	Wolter
Absatz	Absatz
Trockenbauarbeiten	Trockenbauarbeiten
Gewerbebetriebes	Gewerbebetrieb
Forderung	Forderung
Tagesschule	Tagesschule
Strahlendorff	Strahlendorff
Remseck	Remseck
Mehrschalengreifern	Mehrschalengreifern
Bohm	Bohm
eingetragen	eintragen
Seeburg	Seeburg
UW92	UW92
überwiegend	überwiegend
Kraftverkehrswesen	Kraftverkehrswesen
Versteegen	Versteegen
Adamski	Adamski
Möbelausstattung	Möbelausstattung
Handel	Handel
Baustellenvermittlung	Baustellenvermittlung
Rechnertechnik	Rechnertechnik
einige	einige
Stahr	Stahr
veräußern	veräußern
GükG	GükG
Pickert	Pickert
Scholz	Scholz
Co	Co
alleinvertretungsbefugt	alleinvertretungsbefugt
gewinnbringende	gewinnbringend
Motiv	Motiv
Gaststättenbetrieben	Gaststättenbetrieben
Schackert	Schackert
Osterode	Osterode
Obbarius	Obbarius
Träger	Träger
baulogistische	baulogistische
Vollwärmeschutzanlagen	Vollwärmeschutzanlagen
überwachungs	überwachungs
Seifert	Seifert
Geräten	Gerät
Albers	Albers
Tiefbauingenieur	Tiefbauingenieur
Ali	Ali
fördernden	fördernd
Koordinierung	Koordinierung
on	on
Pundt	Pundt
Blutbestandteilen	Blutbestandteilen
Giltrap	Giltrap
gleichartigen	gleichartig
Burau	Burau
Wilke	Wilke
Rohrleitungssystems	Rohrleitungssystem
Servicetätigkeiten	Servicetätigkeiten
Durchführen	Durchführen
Organisationsanalysen	Organisationsanalysen
Geräte	Gerät
Erdbewegungen	Erdbewegung
Rehbrücke	Rehbrücke
Michendorf	Michendorf
vermarkten	vermarkten
kundenspezifische	kundenspezifische
Freizeitsportanlage	Freizeitsportanlage
Krahn	Krahn
SAKE	Sake
Kirschner	Kirschner
verbundener	verbunden
Josimovic	Josimovic
Koproduktion	Koproduktion
Verbuchung	Verbuchung
Altenburg	Altenburg
Lührs	Lührs
Weiterbildung	Weiterbildung
Beck	Beck
Autovermietung	Autovermietung
Video	Video
Karsten	Karsten
Wirtschaftsprüfer	Wirtschaftsprüfer
c	C
Begonia	Begonia
Schulzendorf	Schulzendorf
Erkrath	Erkrath
RS	RS
Projektentwicklungsgesellschaften	Projektentwicklungsgesellschaften
Schuhen	Schuh
Neu	neu
Uferschnepfe	Uferschnepfe
Daten	Datum
Koordination	Koordination
Osterburg	Osterburg
Voigt	Voigt
Wegener	Wegener
Weiterbildungsseminaren	Weiterbildungsseminar
Roszak	Roszak
Schienenfahrzeugen	Schienenfahrzeug
früheren	früh
digitalen	digital
teilen	teilen
Sanierungskonzepten	Sanierungskonzept
benannten	benannt
Beate	Beate
Krahne	Krahne
Gründungsaufwand	Gründungsaufwand
Dem	d
GKT	GKT
Bausatzhäusern	Bausatzhäusern
dienen	dienen
ergebenden	ergebend
Grundstücksankaufsgeschäften	Grundstücksankaufsgeschäften
Beteiligungs	Beteiligungs
jur.	jur.
Ingrid	Ingrid
Ausbildung	Ausbildung
vorbereiten	vorbereiten
Hausfrau	Hausfrau
Beobachtung	Beobachtung
Menges	Menges
Brüggemann	Brüggemann
Schaltanlagen	Schaltanlage
eingeräumt	einräumen
angemessene	angemessen
Trockenlegung	Trockenlegung
Metalle	Metall
Wendland	Wendland
Siegel	Siegel
Büroartikeln	Büroartikeln
Holte	holen
Berliner	Berliner
Burghard	Burghard
Bürgern	Bürgern
genannt	nennen
Kg	kg
Hämerten	Hämerten
Dahlewitz	Dahlewitz
Einbringungsvertrag	Einbringungsvertrag
Don.	Don.
Regina	Regina
Natursteinprodukte	Natursteinprodukte
Rennkarts	Rennkarts
Beilmann	Beilmann
Baschynsky	Baschynsky
Janßen	Janßen
Gerüstarbeiten	Gerüstarbeiten
Tieraufzucht	Tieraufzucht
Mühlhoff	Mühlhoff
Seehof	Seehof
Exner	Exner
Britz	Britz
internationalen	international
Drucksachen	Drucksache
A	A
Bussen	Bus
Gebäudereinigerhandwerks	Gebäudereinigerhandwerks
Mondeo	Mondeo
Hoinka	Hoinka
Deutschland	Deutschland
Kirchhoff	Kirchhoff
betriebswirtschaftlicher	betriebswirtschaftlich
Ziffer	Ziffer
Internets	Internets
Handlung	Handlung
Beschlußfassung	Beschlußfassung
Mike	Mike
Forster	Forster
Luftleitelementen	Luftleitelementen
Umweltbetriebsbeauftragter	Umweltbetriebsbeauftragter
regenerativer	regenerativer
ermächtigt	ermächtigen
Veredelungen	Veredelungen
Spaltungsplanes	Spaltungsplanes
Paulinenaue	Paulinenaue
Gottschalk	Gottschalk
HB	HB
Telekommunikationsanlagen	Telekommunikationsanlage
Behrendt	Behrendt
hausinternen	hausintern
Schulgesetzes	Schulgesetz
erlaubnispflichtiger	erlaubnispflichtiger
derart	derart
Bloß	bloß
Sillack	Sillack
Zeitschriftenverlage	Zeitschriftenverlag
Napiontek	Napiontek
Profilen	Profil
Baubereich	Baubereich
Starkstromleitungen	Starkstromleitung
Beauftragung	Beauftragung
bekanntgemacht	bekanntgemacht
Verlagserzeugnissen	Verlagserzeugnissen
Vetschau	Vetschau
Ronny	Ronny
Rixen	Rixen
Rund	rund
hierzu	hierzu
gekündigt	kündigen
erloschen	erlöschen
Weinmeister	Weinmeister
Alzenau	Alzenau
Preisagentur	Preisagentur
Co.	Co.
schwerpunktmäßig	schwerpunktmäßig
Zusammenhang	Zusammenhang
Ernst	Ernst
fremde	fremd
Cafés	Café
landwirtschaftlichen	landwirtschaftlich
Leasingverträgen	Leasingvertrag
Servicegesellschaft	Servicegesellschaft
Zubehörs	Zubehör
Schlitzwandtechnik	Schlitzwandtechnik
Ruppin	Ruppin
G.	G.
Holzfenstern	Holzfenster
Loose	Loose
stellvertr.	stellvertr.
Winter	Winter
Pagel	Pagel
Spröer	Spröer
Windstromerzeugungsgesellschaft	Windstromerzeugungsgesellschaft
Productions	Productions
Hartog	Hartog
Vermietungsleistungen	Vermietungsleistungen
vermessungstechnischer	vermessungstechnischer
Bergkamen	Bergkamen
Johannistal	Johannistal
Asseln	Assel
fenotec	fenotec
Wegebau	Wegebau
Kommunikationssysteme	Kommunikationssystem
Mietobjekten	Mietobjekt
Susanne	Susanne
Mütter	Mutter
Hamm	Hamm
Allgemeiner	allgemein
Ausnutzung	Ausnutzung
Wartungs	Wartungs
Weichelt	Weichelt
täglichen	täglich
Patientenbeförderung	Patientenbeförderung
Brädikow	Brädikow
Schlingelhof	Schlingelhof
Hochbauleistungen	Hochbauleistungen
Fachwerkbau	Fachwerkbau
Zahlungsmittel	Zahlungsmittel
Biergärten	Biergarten
Umschlag	Umschlag
DAW	DAW
Schnittholz	Schnittholz
Dessau	Dessau
Karg	karg
Vermögensangelegenheiten	Vermögensangelegenheit
Siegen	Siegen
Medienvertriebs	Medienvertriebs
Dr.	Dr.
Servicezentrums	Servicezentrums
Steuerordnungswidrigkeit	Steuerordnungswidrigkeit
Vermessungstechnischen	Vermessungstechnischen
Provisionsbasis	Provisionsbasis
Rat	Rat
Zeitschriften	Zeitschrift
KG	KG
Lehnsdorf	Lehnsdorf
kreative	kreativ
Barnewitz	Barnewitz
Meissner	Meissner
Eine	ein
Natursteinpflasterarbeiten	Natursteinpflasterarbeiten
übertragender	übertragender
programmtechnische	programmtechnische
Insbesondere	insbesondere
TeleVision	Television
Haemapherese	Haemapherese
Ersatzschulen	Ersatzschulen
Lieferung	Lieferung
erteilten	erteilt
Anke	Anke
Lötung	Lötung
Unikaten	Unikat
Abbruch	Abbruch
Bauausführungsleistungen	Bauausführungsleistungen
gesamte	gesamt
berufsvorbereitender	berufsvorbereitender
Nationale	Nationale
Rechtsform	Rechtsform
wirtschaft	Wirtschaft
Thiel	Thiel
Kanalarbeiten	Kanalarbeiten
Medien	Medium
Renovierungsarbeiten	Renovierungsarbeiten
Landgraf	Landgraf
Mirko	Mirko
lufttechnischen	lufttechnischen
Stradmann	Stradmann
zahntechnischen	zahntechnisch
entgeltlich	entgeltlich
NL	NL
Bürodienste	Bürodienste
Veranstaltung	Veranstaltung
Maßgabe	Maßgabe
Passek	Passek
Projektentwicklung	Projektentwicklung
Entgelt	Entgelt
Mustererkennung	Mustererkennung
Seidel	Seidel
Großderschau	Großderschau
schweißtechnischen	schweißtechnischen
diesem	dies
Montage	Montage
Jaruszewski	Jaruszewski
chirurgie	Chirurgie
Tönse	Tönse
Rechenzentrumsbetrieben	Rechenzentrumsbetrieben
Stellvertreterin	Stellvertreterin
erstreckt	erstrecken
dieselbe	dieselbe
schlüsselfertigen	schlüsselfertig
Ausbesserung	Ausbesserung
Pflichtenheften	Pflichtenheften
Einkauf	Einkauf
Poznan	Poznan
Chemco	Chemco
Baureife	Baureife
Einbau	Einbau
York	York
Unternehmern	Unternehmer
aber	aber
Wilimzig	Wilimzig
Änderung	Änderung
Ostrach	Ostrach
massive	massiv
Kaufmann	Kaufmann
Oberleichtersbach	Oberleichtersbach
Christopher	Christopher
Energietechnik	Energietechnik
Niederaula	Niederaula
Optimierung	Optimierung
Brandmelde	Brandmelde
Barkowsky	Barkowsky
Schule	Schule
André	André
Erhaltungsbedarf	Erhaltungsbedarf
Medizin	Medizin
Verleasen	Verleasen
AbfG	AbfG
Rettig	Rettig
ausschließlich	ausschließlich
Wilhelm	Wilhelm
Wladyslaw	Wladyslaw
Wasseraufbereitungs	Wasseraufbereitungs
festen	fest
Reparaturvorhaben	Reparaturvorhaben
Veranstalterfunktion	Veranstalterfunktion
London	London
Vasco	Vasco
etc.	etc.
Borschel	Borschel
Hülya	Hülya
Konservenfabrik	Konservenfabrik
Freier	Freier
artverwandten	artverwandt
Prokurist	Prokurist
Johnny	Johnny
Flughafens	Flughafen
GbR	GbR
Bankprodukten	Bankprodukt
Gesellschaften	Gesellschaft
Form	Form
Behörden	Behörde
Kauffrau	Kauffrau
Tagespresse	Tagespresse
Elektroartikel	Elektroartikel
orthopädietechnischen	orthopädietechnischen
Oeck	Oeck
Deckenkonstruktionen	Deckenkonstruktion
Aufmaß	Aufmaß
genehmigungspflichtiger	genehmigungspflichtig
Peters	Peters
Öffentlichkeitsarbeit	Öffentlichkeitsarbeit
Uwe	Uwe
KJHG	KJHG
Werder	Werder
Shop	Shop
Görzke	Görzke
Stahlbetonbauten	Stahlbetonbauten
Trockenbauprofilen	Trockenbauprofilen
Informationstechnik	Informationstechnik
IKB	IKB
nach	nach
kontaminierte	kontaminiert
befreiten	befreit
Musikproduktionen	Musikproduktion
Karagöz	Karagöz
Local	Local
Ing.	Ing.
Diagnostika	Diagnostika
mediennaher	mediennaher
Bamme	Bamme
Prokura	Prokura
Göttinger	Göttinger
Busch	Busch
Bezirken	Bezirk
Bahrain	Bahrain
Bahnen	Bahnen
Elektrobedarf	Elektrobedarf
Sind	sein
sämtlicher	sämtlich
Münchehofe	Münchehofe
Ausrüstung	Ausrüstung
Walli	Walli
Teilen	Teilen
befugt	befugen
Christiansen	Christianse
Tonträgern	Tonträger
Datenerfassungstätigkeiten	Datenerfassungstätigkeiten
Massivhäusern	Massivhäusern
Wende	Wende
sonstige	sonstig
Kulturträger	Kulturträger
planungsgemäße	planungsgemäße
e.K.	e.K.
Kapitalbeteiligung	Kapitalbeteiligung
Bonn	Bonn
Transportieren	Transportieren
Transporten	Transport
Grünwald	Grünwald
Bauteilen	Bauteilen
Möbeltransporten	Möbeltransporten
Betriebssystemen	Betriebssystem
Wasserversorgung	Wasserversorgung
Training	Training
Bündelfunk	Bündelfunk
gefaßt	fassen
Bundeanzeiger	Bundeanzeiger
Bereitschaftsdienst	Bereitschaftsdienst
Tiefbaumaßnahmen	Tiefbaumaßnahme
Kutlay	Kutlay
Waltraud	Waltraud
Antlitz	Antlitz
Satz	Satz
Förderer	Förderer
Freizeitstätten	Freizeitstätte
hierin	hierin
Bohlen	Bohle
Haupt	Haupt
Card	Card
Trainingsmaßnahmen	Trainingsmaßnahme
verwandte	verwandt
ff	ff
Haustechnik	Haustechnik
ländlichen	ländlich
alleinvertretungsberechtigt	alleinvertretungsberechtigt
Hardwarebereich	Hardwarebereich
Ramstetter	Ramstetter
Angeles	Angeles
Archivierungsleistungen	Archivierungsleistungen
Dosse	Dosse
Lizenz	Lizenz
Heilbronn	Heilbronn
Schmädicke	Schmädicke
dritte	dritt
Vehlen	Vehlen
Wendenburg	Wendenburg
Fürth	Fürth
TF	TF
Leder	Leder
Quarz	Quarz
Dieter	Dieter
Fensterdeko	Fensterdeko
Erdaufbereitungsanlage	Erdaufbereitungsanlage
Blitzschutzanlagen	Blitzschutzanlage
Fertigerzeugnissen	Fertigerzeugnissen
talentierte	talentiert
resultierenden	resultierend
aller	alle
sicherheitstechnischen	sicherheitstechnisch
Flächensicherung	Flächensicherung
Enrico	Enrico
Verbraucher	Verbraucher
anwendungsorientierten	anwendungsorientiert
jotaaquila	jotaaquila
Rossol	Rossol
gastronomischen	gastronomisch
Handwerksordnung	Handwerksordnung
Prof._Dr	Prof._Dr
Drahtartikeln	Drahtartikeln
anderswo	anderswo
Aufsichtsrates	Aufsichtsrat
Ersatzteilhandel	Ersatzteilhandel
Abschluss	Abschluss
Kraftfahrzeugteilen	Kraftfahrzeugteilen
Bei	bei
Wendisch	Wendisch
Sägewerkes	Sägewerk
Jochen	Jochen
Cindy	Cindy
Natursteinpflaster	Natursteinpflaster
zerfällt	zerfallen
MaBV	MaBV
diesbezüglicher	diesbezüglich
Baufeld	Baufeld
Stern	Stern
verbriefte	verbriefte
Gesundheit	Gesundheit
Rosenkranz	Rosenkranz
errichtenden	errichtend
Einzelhandels	Einzelhandel
Plasmapherese	Plasmapherese
Standke	Standke
Köngis	Köngis
studiotechnischen	studiotechnischen
wozu	wozu
Vorschrift	Vorschrift
Trassen	Trassen
Landwirtschaft	Landwirtschaft
Bukovsky	Bukovsky
Breitbandkabel	Breitbandkabel
Lieferverträge	Liefervertrag
Schmerzke	Schmerzke
Nutzfahrzeughandel	Nutzfahrzeughandel
Unfall	Unfall
Unternehmensnetzwerke	Unternehmensnetzwerke
Versicherungsbüros	Versicherungsbüro
Hönighaus	Hönighaus
Anzeigensuche	Anzeigensuche
Damsdorf	Damsdorf
Energielieferverträgen	Energielieferverträgen
Elektroanlagen	Elektroanlage
Dienstleistungsverträgen	Dienstleistungsverträgen
Ausgliederungsplan	Ausgliederungsplan
wenn	wenn
Tele	Tele
Wildenbruch	Wildenbruch
Amtsgericht	Amtsgericht
Senkung	Senkung
Recycling	Recycling
e.	e.
vorgenannten	vorgenannt
beschlossen	beschließen
unabhängiger	unabhängig
Grundstücksgeschäfte	Grundstücksgeschäft
Feuerungs	Feuerungs
Bautenschutzarbeiten	Bautenschutzarbeiten
Bewertungsunterlagen	Bewertungsunterlagen
Wasserwirtschaft	Wasserwirtschaft
Geschäftsbesorgung	Geschäftsbesorgung
Befestigungstechnik	Befestigungstechnik
Ferkeln	Ferkel
Holzwerk	Holzwerk
Zippold	Zippold
a	A
Sanierung	Sanierung
sie	sie
Baustelleneinrichtungen	Baustelleneinrichtung
Bauteile	Bauteil
Diplom	Diplom
Datenservicearbeiten	Datenservicearbeiten
namens	namens
Düngern	Dünger
Arnst	Arnst
fallen	fallen
Stückaktien	Stückaktien
Hattwig	Hattwig
Thieme	Thieme
Neufassung	Neufassung
Tagesreisen	Tagesreisen
zusammenhängenden	zusammenhängend
Trägerschaft	Trägerschaft
Eckert	Eckert
Plätzen	Platz
Transportmitteln	Transportmitteln
Fenner	Fenner
umgestellt	umstellen
Ausschluss	Ausschluss
Langensteinbach	Langensteinbach
mehrfach	mehrfach
Bauausführung	Bauausführung
Motzen	Motzen
Steuergesetzen	Steuergesetz
Wartungsdienst	Wartungsdienst
Geberth	Geberth
Filmbeiträge	Filmbeitrag
Planung	Planung
Werbung	Werbung
Witzke	Witzke
Gesichtspunkten	Gesichtspunkten
Lotte	Lotte
Nonnendorf	Nonnendorf
Baubedarf	Baubedarf
Werben	Werben
Frankfurt	Frankfurt
denen	d
Dolgner	Dolgner
Gustke	Gustke
Um	um
Multimediale	Multimediale
Denkmalschutzes	Denkmalschutz
Unternehmensberater	Unternehmensberater
Lager	Lager
Beelitz	Beelitz
bezüglich	bezüglich
Bestandsunterlagen	Bestandsunterlagen
Holzfasern	Holzfasern
Glonn	Glonn
Bonanni	Bonanni
Daria	Daria
Physikalische	Physikalische
Jutta	Jutta
Verlagstätigkeit	Verlagstätigkeit
Petrak	Petrak
Betriebswirt	Betriebswirt
Ursula	Ursula
Wasserfahrzeugen	Wasserfahrzeug
Lieferungen	Lieferung
Privatschule	Privatschule
Schmökel	Schmökel
Käske	Käske
Umweltschutz	Umweltschutz
Fachliteratur	Fachliteratur
diverse	divers
öffentlich	öffentlich
Bahnhöfen	Bahnhof
Kiefernorthopäde	Kiefernorthopäde
Donath	Donath
Loop	Loop
Rees	Rees
Edeltraut	Edeltraut
Wickert	Wickert
Bernburg	Bernburg
beweglicher	beweglich
Konzeptionierung	Konzeptionierung
Filtertechnik	Filtertechnik
befindet	befinden
erforderlicher	erforderlich
Glienicke	Glienicke
Speditionswesen	Speditionswesen
Aufstellung	Aufstellung
Schultz	Schultz
Rehage	Rehage
Lizenzhandel	Lizenzhandel
Fonds	Fonds
Chlorgas	Chlorgas
Korytko	Korytko
Erschließung	Erschließung
landschaftsplanerischen	landschaftsplanerischen
Milde	Milde
Hans	Hans
SC	SC
Länder	Land
Haßmann	Haßmann
mittelbar	mittelbar
Schwanebeck	Schwanebeck
eines	ein
Softwareprodukten	Softwareprodukt
Freizeitangebot	Freizeitangebot
Führung	Führung
Heizungsbau	Heizungsbau
Gisela	Gisela
Nadine	Nadine
Frankfurt_am_Main	Frankfurt_am_Main
besondere	besonder
Ratingen	Ratingen
personalrelevanten	personalrelevanten
kommen	kommen
Bauzuschlagsstoffen	Bauzuschlagsstoffen
Priester	Priester
Jacqueline	Jacqueline
Wärmeversorgung	Wärmeversorgung
Umlaufvermögen	Umlaufvermögen
Wohneigentümer	Wohneigentümer
Kraftfahrzeugtechnikerhandwerks	Kraftfahrzeugtechnikerhandwerks
Komponenten	Komponente
Evaluation	Evaluation
Genehmigungen	Genehmigung
BGB	BGB
Charakter	Charakter
gerichtet	richten
Hellenthal	Hellenthal
identity	identity
Handwerks	Handwerk
verwirklicht	verwirklichen
Selm	Selm
Pleß	Pleß
Handwerksleistungen	Handwerksleistung
Kabelkonfektion	Kabelkonfektion
Betonbauarbeiten	Betonbauarbeiten
Erstellung	Erstellung
MOL	Mol
Lidl	Lidl
Steuersachen	Steuersache
Konzeptionserstellung	Konzeptionserstellung
Antrifttal	Antrifttal
Gallun	Gallun
Tiefbaues	Tiefbaues
deren	d
Rohren	Rohr
WHG	WHG
Niedergörsdorf	Niedergörsdorf
Gardelegen	Gardelegen
Uhrbach	Uhrbach
Seiler	Seiler
Gewinn	Gewinn
Sichern	Sichern
Wartenburg	Wartenburg
Umrüstung	Umrüstung
Göttlin	Göttlin
Fukurawa	Fukurawa
Zeuthen	Zeuthen
Prüfberichte	Prüfbericht
Juweliereinzelhandel	Juweliereinzelhandel
Wohnungsverwaltungsgesellschaft	Wohnungsverwaltungsgesellschaft
Schiedsgericht	Schiedsgericht
Material	Material
Gebietes	Gebiet
Fitnessanlage	Fitnessanlage
Umgestaltung	Umgestaltung
Stricker	Stricker
Haltung	Haltung
Verkaufsförderung	Verkaufsförderung
können	können
Aggregaten	Aggregat
Breitenstein	Breitenstein
Buntingford	Buntingford
Textil	Textil
Jagalla	Jagalla
Schwartz	Schwartz
Hilbrecht	Hilbrecht
sanierung	Sanierung
sozialen	sozial
hierauf	hierauf
ausgenommen	ausgenommen
forstlicher	forstlicher
Sie	Sie
Buck	Buck
Gelegenheit	Gelegenheit
Kantinenversorgung	Kantinenversorgung
Appel	Appel
Blankenfelde	Blankenfeld
Schulungs	Schulungs
Falge	Falge
Bielefeld	Bielefeld
MEGA	MEGA
Lutz	Lutz
Demontagetätigkeiten	Demontagetätigkeiten
alternativen	alternativ
unternehmensinterner	unternehmensinterner
Hochbauplanung	Hochbauplanung
Abruf	Abruf
Beiprogramme	Beiprogramm
Gonnermann	Gonnermann
Neye	Neye
Gebieten	Gebieten
ingenieurtechnischen	ingenieurtechnisch
Deursen	Deursen
Mitwirkung	Mitwirkung
Cuwie	Cuwie
Abfallwirtschafts	Abfallwirtschafts
Lohnbuchhaltungsarbeiten	Lohnbuchhaltungsarbeiten
Warenkontor	Warenkontor
Luise	Luise
Haussanierung	Haussanierung
Auslandsgeschäfte	Auslandsgeschäft
Karow	Karow
haftende	haftend
Rusczyk	Rusczyk
Fünf	Fünf
Halten	Halten
Neuendorf	Neuendorf
InvestitionsBank	Investitionsbank
Ernährungsprodukten	Ernährungsprodukten
ausländischer	ausländisch
Schloßgut	Schloßgut
Auflagen	Auflage
Sans	Sans
Versicherung	Versicherung
Solf	Solf
Sommer	Sommer
Plötzin	Plötzin
sich	sich
Ostsachsen	Ostsachsen
Busendorf	Busendorf
Finanzierungsvermittlungen	Finanzierungsvermittlungen
enge	eng
Buchrechten	Buchrechten
mbH	mbH
Ausschluß	Ausschluß
Sachverhalten	Sachverhalt
ä.	ä.
bb	bb
Bausektor	Bausektor
Seibelsdorf	Seibelsdorf
Nutzungskonzepten	Nutzungskonzept
Finanzoptimierung	Finanzoptimierung
Datenverarbeitungsanwendungen	Datenverarbeitungsanwendungen
Abfällen	Abfällen
Dieser	dies
Gruhl	Gruhl
Bedarfsartikeln	Bedarfsartikeln
Filmkaufmann	Filmkaufmann
professioneller	professionell
Zinna	Zinna
Norbert	Norbert
D.	D.
Industrieerzeugnissen	Industrieerzeugnis
Voraussetzungen	Voraussetzung
Programmrechten	Programmrechten
Buchst	buchen
Information	Information
Baruth	Baruth
chemischen	chemisch
Gelände	Gelände
Containerdienst	Containerdienst
dabei	dabei
Elke	Elke
Wirtschafts	Wirtschafts
Kelling	Kelling
N	N
Grundbuch	Grundbuch
vermarktungsfähige	vermarktungsfähig
Sicherheitstechnik	Sicherheitstechnik
Kommunikationstechnologie	Kommunikationstechnologie
Toilettenkabinen	Toilettenkabinen
Brandschutzisolierungen	Brandschutzisolierungen
Deutschen	Deutsche
Verlagsbereich	Verlagsbereich
Blutkonserven	Blutkonserve
Geschäfts	Geschäft
Finnland	Finnland
Reihen	Reihen
Merseburg	Merseburg
Matthias	Matthias
Angelegenheiten	Angelegenheit
Veräußerung	Veräußerung
Renovierungsartikeln	Renovierungsartikeln
Taunusstein	Taunusstein
Erziehungsinhalte	Erziehungsinhalt
Auftrage	Auftrag
Maler	Maler
Berends	Berends
abzusschließen	abzusschließen
Birgitt	Birgitt
Steffen	Steffen
Radio	Radio
Haftpflicht	Haftpflicht
Jaffke	Jaffke
Zementindustrie	Zementindustrie
Sanierungsobjekte	Sanierungsobjekt
Holzhäusern	Holzhaus
Gloy	Gloy
Jaskorski	Jaskorski
Bio	Bio
Gebäudereinigung	Gebäudereinigung
KA	KA
Ausbaumaterial	Ausbaumaterial
bizzcomm	bizzcomm
Kündigung	Kündigung
Umweltmanagementsystemen	Umweltmanagementsystemen
Birk	Birk
Küchengeräten	Küchengerät
Afghanistan	Afghanistan
Reiseprogrammen	Reiseprogrammen
Familienjubiläen	Familienjubiläen
Projektdurchführung	Projektdurchführung
Gröbenzell	Gröbenzell
zulässig	zulässig
Bork	Bork
Erwerbsgesellschaft	Erwerbsgesellschaft
Tischler	Tischler
Prüfungsberichte	Prüfungsbericht
AGE	AGE
Organ	Organ
Marie	Marie
selbstlos	selbstlos
Scharberger	Scharberger
Ingenieursarbeiten	Ingenieursarbeiten
u.a.m.	u.a.m.
Kabelabfälle	Kabelabfälle
bestellt	bestellen
solange	solange
Gebauer	Gebauer
Hubrich	Hubrich
elektrischen	elektrisch
Tokic	Tokic
Scherbatzki	Scherbatzki
amtl.	amtl.
zivilen	zivil
Instandsetzung	Instandsetzung
Dietmar	Dietmar
Pflastern	Pflastern
Schurig	Schurig
Abgabenordnung	Abgabenordnung
Stukkateurarbeiten	Stukkateurarbeiten
Dachstühle	Dachstuhl
diagnostischen	diagnostisch
Fertighäusern	Fertighaus
außerhalb	außerhalb
abwicklung	Abwicklung
ingenieurwissenschaftlichen	ingenieurwissenschaftlich
Investitions	Investitions
AWE	AWE
Radebeul	Radebeul
Verkaufsförderungs	Verkaufsförderungs
Bräunungsanlagen	Bräunungsanlagen
Mellensee	Mellensee
Feuerwehr	Feuerwehr
Fabian	Fabian
lauten	lauten
Zusammenarbeit	Zusammenarbeit
Einzelunternehmen	Einzelunternehmen
Menzfeldt	Menzfeldt
Ausschreibungsverfahren	Ausschreibungsverfahren
Wüstenberg	Wüstenberg
Pflege	Pflege
Softwareberatung	Softwareberatung
Software	Software
Bauwerksabdichtung	Bauwerksabdichtung
Klomp	Klomp
eingetragene	eingetragen
danach	danach
Landschaftsbaufirmen	Landschaftsbaufirmen
Immobilien	Immobilie
zwar	zwar
o.	oder
Roden	Roden
Glasermeisterin	Glasermeisterin
Anneliese	Anneliese
Burgstädt	Burgstädt
Marktbeobachtung	Marktbeobachtung
weiterer	weit
weiterhin	weiterhin
Pawel	Pawel
Speditions	Speditions
Perönlich	Perönlich
Liegenschaften	Liegenschaft
Gas	Gas
Ausgenommen	ausgenommen
Zeithain	Zeithain
Produktionsanlagen	Produktionsanlage
Fleisch	Fleisch
Abläufe	Ablauf
Bürogebäudes	Bürogebäude
Erlebnisgastronomie	Erlebnisgastronomie
Gebäudemanagement	Gebäudemanagement
Empfangsanlagen	Empfangsanlage
Gehrke	Gehrke
ändern	ändern
Umformtechnik	Umformtechnik
Versicherungsschutz	Versicherungsschutz
Ziock	Ziock
Tourismus	Tourismus
Polen	Polen
Proschek	Proschek
Projekte	Projekt
wirtschaftlich	wirtschaftlich
vermittelten	vermittelt
Hörgeräten	Hörgerät
Maurerarbeiten	Maurerarbeiten
Entsorgung	Entsorgung
Metallen	Metall
Vilbel	Vilbel
Vorobieva	Vorobieva
möglichen	möglich
gewerbliche	gewerblich
Kahle	Kahle
Seerhausen	Seerhausen
Psychotherapie	Psychotherapie
Zudem	zudem
Eigenheimen	Eigenheim
Gabelstapler	Gabelstapler
schneidarbeiten	schneidarbeiten
Republik	Republik
Vererbung	Vererbung
Rosmarie	Rosmarie
Betreuungspflege	Betreuungspflege
Zimpel	Zimpel
bedienen	bedienen
Duchrow	Duchrow
Gesellschaftsmitteln	Gesellschaftsmitteln
anmelden	anmelden
Security	Security
jetzt	jetzt
Ausbauhaus	Ausbauhaus
Handwerker	Handwerker
Sträuchern	Strauch
Wasserstraßen	Wasserstraße
Unternehmenszwecks	Unternehmenszwecks
Leheta	Leheta
Kloster	Kloster
Telekommunikationseinrichtungen	Telekommunikationseinrichtung
Treppen	Treppe
Meerbusch	Meerbusch
Yüksel	Yüksel
hin	hin
heizungs	heizungs
Gakenholz	Gakenholz
Randsortimenten	Randsortimenten
Formularen	Formular
geschlossen	schließen
Nebenleistungen	Nebenleistung
aufgrund	aufgrund
Hereford	Hereford
Lattung	Lattung
Lurz	Lurz
Märkisch	Märkisch
Grundwasserabsenkungen	Grundwasserabsenkungen
Unterhaltungsbranche	Unterhaltungsbranche
beider	beide
Jakisch	Jakisch
Genußrechte	Genußrechte
INTUS	intus
In	in
Druckmedien	Druckmedium
Der	d
Staatsanzeiger	Staatsanzeiger
Werkstattplanung	Werkstattplanung
Vertretung	Vertretung
Pröhl	Pröhl
Wäscherei	Wäscherei
Videotechnik	Videotechnik
Lüdinghausen	Lüdinghausen
Leipzig	Leipzig
Güsen	Güsen
Krauskopf	Krauskopf
Werken	Werken
Wassersanierung	Wassersanierung
Behälterbau	Behälterbau
Kranken	Kranke
Niestlé	Niestlé
nachweisbaren	nachweisbar
Caravan	Caravan
Fragen	Fragen
Identity	Identity
Angestellten	Angestellte
Kabelschneid	Kabelschneid
Befugnis	Befugnis
Telekommunikationslizenzen	Telekommunikationslizenzen
Dauer	Dauer
Forschungsaufträge	Forschungsauftrag
Gebiet	Gebiet
Ohlhöft	Ohlhöft
Motorsportzubehör	Motorsportzubehör
Entstanden	entstehen
Gladbach	Gladbach
Altrip	Altrip
Flugdienstleistungs	Flugdienstleistungs
melden	melden
Systemintegration	Systemintegration
Neubrandenburg	Neubrandenburg
Mineralstoffe	Mineralstoff
Gewinnverwendung	Gewinnverwendung
Kellerbauten	Kellerbauten
Waschen	Waschen
LAURANA	LAURANA
Matysik	Matysik
Sicherheitsanlagen	Sicherheitsanlage
Stoffe	Stoff
Lohr	Lohr
unterliegen	unterliegen
Wroclaw	Wroclaw
Einzelrechtsnachfolge	Einzelrechtsnachfolge
Freiherr	Freiherr
Unternehmens	Unternehmen
private	privat
Umfangreiches	umfangreich
Werkverkehr	Werkverkehr
Schug	Schug
Herwarth	Herwarth
Betreibergesellschaften	Betreibergesellschaft
noch	noch
nicht	nicht
steuerlichen	steuerlich
Ahrens	Ahrens
LKW	LKW
Thiemann	Thiemann
durchgeführt	durchführen
vollständiger	vollständig
Michaelis	Michaelis
Güterverkehr	Güterverkehr
Vollwärmeschutzfassaden	Vollwärmeschutzfassaden
Fellbach	Fellbach
Manuel	Manuel
Gentechnologien	Gentechnologie
Mess	Mess
Muschert	Muschert
Fernseh	Fernseh
Fernsehprojekte	Fernsehprojekt
abgeändert	abändern
Bauhauptgewerk	Bauhauptgewerk
Schreck	Schreck
Books	Books
Büroeinrichtungen	Büroeinrichtung
Wohnimmobilie	Wohnimmobilie
Verwaltungsaufgaben	Verwaltungsaufgabe
Jänicke	Jänicke
hinsichtlich	hinsichtlich
Engeneering	Engeneering
Krüger	Krüger
mittleren	mittler
Eintrittskarten	Eintrittskarte
bituminöser	bituminöser
Gegenständen	Gegenstand
ausgewählte	ausgewählt
Potsdamer	Potsdamer
erteilen	erteilen
Großhandel	Großhandel
orientierten	orientiert
Föse	Föse
Stelle	Stelle
Fitneßstudios	Fitneßstudio
beteiligten	beteiligt
Aufgaben	Aufgabe
Pietzsch	Pietzsch
externer	extern
geowissenschaftlichen	geowissenschaftlichen
Barkóczi	Barkóczi
entgeltliche	entgeltliche
Siebold	Siebold
Hach	Hach
Formwechsel	Formwechsel
Schollene	Schollene
Errichten	Errichten
Kraftfahrzeugen	Kraftfahrzeug
B.	B.
Ausbaues	Ausbau
Schuh	Schuh
Citroen	Citroen
Logistischen	logistisch
Maskottchen	Maskottchen
vermessungstechnischen	vermessungstechnischen
gelegentlichen	gelegentlich
Produktdesign	Produktdesign
ter	ter
Kanals	Kanal
Immobilienverwaltung	Immobilienverwaltung
Kerler	Kerler
Beata	Beata
Jahresabschlüssen	Jahresabschluß
Commerce	Commerce
Abtretung	Abtretung
Runge	Runge
Tino	Tino
Ziff.	Ziff.
348D0093	348D0093
Betonfertigfabrikaten	Betonfertigfabrikaten
Datenverarbeitung	Datenverarbeitung
Fertigung	Fertigung
artverwandter	artverwandt
Darlehen	Darlehen
Tod	Tod
schriftlicher	schriftlich
Völkerverständigung	Völkerverständigung
Cinema	Cinema
Saalow	Saalow
Sören	Sören
Baustoffhandel	Baustoffhandel
Datenregistern	Datenregistern
Gronemeier	Gronemeier
Jagdwirtschaft	Jagdwirtschaft
Beherrschungsvertrag	Beherrschungsvertrag
Neon	Neon
Huber	Huber
Kapitalgesellschaften	Kapitalgesellschaft
Bürotechnik	Bürotechnik
Sickerwässer	Sickerwässer
betreuten	betreut
Quirnbach	Quirnbach
Logistik	Logistik
Ziche	Ziche
Türen	Türen
Pflegeeinrichtungen	Pflegeeinrichtung
Verena	Verena
Außenanlagen	Außenanlage
abschließen	abschließen
biotechnologischen	biotechnologisch
Themen	Thema
Finke	Finke
Kopierknecht	Kopierknecht
Pätz	Pätz
Mazer	Mazer
lüftungstechnischen	lüftungstechnischen
Cinerenta	Cinerenta
eigener	eigen
Artikel	Artikel
Einzelhandelsbereich	Einzelhandelsbereich
Unternehmensverwertungen	Unternehmensverwertungen
Lande	Land
Jörg	Jörg
erwirbt	erwerben
Haushaltsgeräte	Haushaltsgerät
Schulungsdienstleistungen	Schulungsdienstleistungen
verwaltet	verwalten
Orten	Orten
Belzig	Belzig
trägt	tragen
Bauspar	Bauspar
Jaks	Jaks
Vermessungen	Vermessung
Bierbrodt	Bierbrodt
Christian	Christian
abgedeckt	abdecken
Einzelunternehmens	Einzelunternehmens
Gustav	Gustav
Wartungsarbeiten	Wartungsarbeiten
Andras	Andras
Denkmalpflege	Denkmalpflege
Stukk	Stukk
Generalunternehmer	Generalunternehmer
Massenberechnungen	Massenberechnungen
landwirtschaftlicher	landwirtschaftlich
Gartenholz	Gartenholz
Dipl.-Kfm	Dipl.-Kfm
Gehwegen	Gehweg
Investitionskonzepten	Investitionskonzepten
Liftanlagen	Liftanlage
wassertechnischen	wassertechnischen
Zeestow	Zeestow
Trockenausbauarbeiten	Trockenausbauarbeiten
schlüsselfertiger	schlüsselfertiger
Fachgebiete	Fachgebiet
Kaufhold	Kaufhold
Mittelbrandenburgische	Mittelbrandenburgische
WeGeHo	WeGeHo
Sand	Sand
Hängen	Hängen
Demontage	Demontage
Bausatzsystemen	Bausatzsystemen
keinerlei	keinerlei
Udo	Udo
Außensanierungsarbeiten	Außensanierungsarbeiten
Sportmanager	Sportmanager
Schleiter	Schleiter
Rohrbeck	Rohrbeck
Baunebenleistungen	Baunebenleistungen
Vollwärmeschutz	Vollwärmeschutz
Intranet	Intranet
Lindenburger	Lindenburger
Endoprothetik	Endoprothetik
Djeric	Djeric
Thoben	Thoben
Männel	Männel
Handelswaren	Handelsware
FALB	falb
Betrieben	Betrieb
erfolgt	erfolgen
heizungstechnische	heizungstechnische
mittels	mittels
Bruckmühl	Bruckmühl
Biergartens	Biergarten
Fußbodenbau	Fußbodenbau
Produkteinführung	Produkteinführung
Tätige	Tätige
Vermögenswerte	Vermögenswert
Hauspflegedienste	Hauspflegedienste
Pohnitzer	Pohnitzer
Baustellenabfällen	Baustellenabfällen
Staaken	Staaken
Meßtechnik	Meßtechnik
Vermietung	Vermietung
Rechtsanwalt	Rechtsanwalt
Sigrid	Sigrid
Appartements	Appartement
zehn	zehn
Gransee	Gransee
See	See
P.	P.
Wolf	Wolf
Warentransporte	Warentransport
Funck	Funck
l	l
anpassung	Anpassung
verarbeitung	Verarbeitung
Computerprogrammen	Computerprogramm
ihren	ihr
Umweltberatung	Umweltberatung
Nord	Nord
Neithard	Neithard
Umwandlungsgesetz	Umwandlungsgesetz
maschinelle	maschinell
agromax	agromax
strategischer	strategisch
Püth	Püth
Bildungs	Bildungs
Abfallgesetzes	Abfallgesetz
Erkner	Erkner
Speditionsleistungen	Speditionsleistungen
Dabei	dabei
Freizeitbereich	Freizeitbereich
stellvertreter	Stellvertreter
Dänemark	Dänemark
Engel	Engel
Alpinvest	Alpinvest
Rotter	Rotter
Birol	Birol
Gorsky	Gorsky
Tage	Tag
Bahnschotter	Bahnschotter
Westland	Westland
Gericke	Gericke
Mosaiken	Mosaik
Landthaler	Landthaler
UmwG	UmwG
GÖFAK	GÖFAK
Beherbergung	Beherbergung
Ramona	Ramona
Geschäftsbauten	Geschäftsbau
Hannover	Hannover
Burgholzhausen	Burgholzhausen
Görlitz	Görlitz
Computersystemen	Computersystem
Tätigkeit	Tätigkeit
Lattke	Lattke
Türkei	Türkei
Vollstädt	Vollstädt
aufsichtsrat	Aufsichtsrat
Genehmigtes	genehmigt
sanitärem	sanitärem
Kleintransporten	Kleintransporten
Deger	Deger
Zorica	Zorica
Beyer	Beyer
Werbemaßnahmen	Werbemaßnahme
Linie	Linie
Stahnsdorf	Stahnsdorf
Design	Design
Weg	Weg
Thümmler	Thümmler
Gestellbaues	Gestellbaues
Anschütz	Anschütz
unterhält	unterhalten
Umwanldung	Umwanldung
betriebenen	betrieben
amerikanischen	amerikanisch
Landschaftsbauarbeiten	Landschaftsbauarbeiten
Weiterentwicklung	Weiterentwicklung
Reifen	Reifen
Ventures	Ventures
Rohrleitungssanierung	Rohrleitungssanierung
Gebäude	Gebäude
Kind	Kind
Schorndorf	Schorndorf
Recyceln	Recyceln
Helf	Helf
Steffel	Steffel
vorliegenden	vorliegend
Oelke	Oelke
Innenräumen	Innenräumen
Ermisch	Ermisch
erbringen	erbringen
Holztüren	Holztüren
Kirsten	Kirsten
Veterinärmedizin	Veterinärmedizin
Baumpflege	Baumpflege
Hobelware	Hobelware
Emrich	Emrich
Schrotten	Schrotten
Baumanagements	Baumanagements
Diagnose	Diagnose
Versicherungsvermittlung	Versicherungsvermittlung
Praktikumsplätze	Praktikumsplatz
Friedel	Friedel
Produkten	Produkt
Werbemittelherstellung	Werbemittelherstellung
Kapitalanlagengesellschaft	Kapitalanlagengesellschaft
dienendem	dienendem
zugunsten	zugunsten
verschoben	verschieben
Weißig	Weißig
Tim	Tim
Getreide	Getreide
Kathewitz	Kathewitz
Cateringleistungen	Cateringleistungen
Nennwert	Nennwert
Steuerpflichtigen	Steuerpflichtige
Marzahne	Marzahne
Fortsetzung	Fortsetzung
Fügner	Fügner
Zimmerer	Zimmerer
Sieg	Sieg
Putzstoffen	Putzstoffen
Giengen	Giengen
Nairobi	Nairobi
Wünsdorf	Wünsdorf
IT	it
Bauschlosserei	Bauschlosserei
an	an
angesiedelt	ansiedeln
Spritzverzinken	Spritzverzinken
Entwickeln	Entwickeln
Vertriebswegen	Vertriebsweg
RW	RW
haltung	Haltung
Beratungen	Beratung
Anwendung	Anwendung
Estrichlegerei	Estrichlegerei
letztgenannte	letztgenannt
Elert	Elert
Forschungsansätze	Forschungsansatz
Herr	Herr
Fugen	Fugen
Gärten	Garten
Hermann	Hermann
Hennig	Hennig
Kauhausen	Kauhausen
van	van
Scherpenheuvel	Scherpenheuvel
Leasen	Leasen
Werbeträgern	Werbeträger
Gutowski	Gutowski
Betrieb	Betrieb
Lauchstädt	Lauchstädt
Grundstücks	Grundstück
Brückenbau	Brückenbau
derselben	derselben
Wasserinstallationsarbeiten	Wasserinstallationsarbeiten
Leistungsspektrum	Leistungsspektrum
Menden	Menden
europäischen	europäisch
Hof	Hof
Katja	Katja
hygienischen	hygienisch
Besorgung	Besorgung
Basis	Basis
verschmolzen	verschmelzen
aa	aa
Schulungsprogramme	Schulungsprogramm
Marianne	Marianne
Filmtheatern	Filmtheater
Kraatz	Kraatz
Scheel	Scheel
Geldspiel	Geldspiel
wissenschaftliche	wissenschaftlich
Baubegutachtung	Baubegutachtung
Honorarordnung	Honorarordnung
verleasen	verleasen
Kapitalanlagegesetz	Kapitalanlagegesetz
Shopeinrichtungen	Shopeinrichtungen
Am	am
Prägitzer	Prägitzer
Trend	Trend
Frau	Frau
Kurz	Kurz
Identifikation	Identifikation
Betreuer	Betreuer
Fruchtweinen	Fruchtweinen
Heike	Heike
GEF	GEF
Eleonore	Eleonore
stimmen	stimmen
Rahmen	Rahmen
Wilma	Wilma
Einspeisung	Einspeisung
Trucks	Truck
Görsch	Görsch
Partizipation	Partizipation
Franzke	Franzke
verwertbaren	verwertbar
Loerzer	Loerzer
Krauß	Krauß
Anlagevermögens	Anlagevermögen
Bielck	Bielck
Zustimmungsbeschlüsse	Zustimmungsbeschlüsse
LDS	LDS
Peine	Peine
Bilgen	Bilge
beauftragter	beauftragt
Knaak	Knaak
Studium	Studium
Warner	Warner
Krzyskowski	Krzyskowski
Logistikzentrum	Logistikzentrum
Designer	Designer
Krenzin	Krenzin
Wansdorf	Wansdorf
Roth	Roth
Thorsten	Thorsten
Gesamtprokura	Gesamtprokura
Hand	Hand
Anteilscheinen	Anteilscheinen
Elsfleth	Elsfleth
Torremuellen	Torremuellen
Wiggins	Wiggins
Eisen	Eisen
Lackierarbeiten	Lackierarbeiten
Geraldo	Geraldo
Mehrteiler	Mehrteiler
Privatisierungsvertrag	Privatisierungsvertrag
Funke	Funke
Theo	Theo
Postkarten	Postkarte
Kentrup	Kentrup
Gesellschafterbeschluß	Gesellschafterbeschluß
non	non
Slupsk	Slupsk
Rohrvortrieb	Rohrvortrieb
Central	Central
fremden	fremd
Bildträger	Bildträger
gegen	gegen
vetritt	vetritt
konzeptionelle	konzeptionell
Zinke	Zinke
Shampoonierung	Shampoonierung
Einsammeln	Einsammeln
Electronic	Electronic
Bienger	Bienger
Hauschild	Hauschild
Rienharz	Rienharz
Bärbel	Bärbel
Industrieerzeugnisse	Industrieerzeugnis
Gilka	Gilka
Bauwerksabdichtungen	Bauwerksabdichtungen
Bohnhorst	Bohnhorst
Glowacki	Glowacki
Fernsehveranstalter	Fernsehveranstalter
Kieback	Kieback
Sport	Sport
Massinger	Massinger
Gullyreinigung	Gullyreinigung
Ingenieurleistungen	Ingenieurleistung
Berge	Berg
Demuth	Demuth
Qualitätseigenschaften	Qualitätseigenschaften
wird	werden
Dienstleistungsbereich	Dienstleistungsbereich
sämtlichen	sämtlich
Altauto	Altauto
Lüftungsanlagen	Lüftungsanlage
Gewinnverteilung	Gewinnverteilung
interaktiven	interaktiv
vornehmen	vornehm
Konflikte	Konflikt
Papierwaren	Papierware
überwacht	überwachen
teilzunehmen	teilnehmen
Franz	Franz
BA	BA
Grundstückskaufvertrag	Grundstückskaufvertrag
Verpflegung	Verpflegung
Mauerwerk	Mauerwerk
Arbeitnehmerüberlassung	Arbeitnehmerüberlassung
Immenkötter	Immenkötter
Kommunikationsangebote	Kommunikationsangebot
Angebot	Angebot
bezieht	beziehen
CargoLifter	CargoLifter
metallbautechnischer	metallbautechnischer
Terrassencafes	Terrassencafes
Wiechert	Wiechert
Kooperationen	Kooperation
Konstruktionsaufträgen	Konstruktionsaufträgen
Ausbaugewerken	Ausbaugewerken
Alarmverfolgung	Alarmverfolgung
Ramstein	Ramstein
Zeitungs	Zeitungs
mindestens	mindestens
Sun	Sun
Boost	Boost
Wieberneit	Wieberneit
Turnieren	Turnieren
Glienick	Glienick
Kopplin	Kopplin
Investmentanteilen	Investmentanteilen
Flüssiggasversorgung	Flüssiggasversorgung
Feuerlöschanlagen	Feuerlöschanlage
Fahrschulausbildung	Fahrschulausbildung
Marzilger	Marzilger
Werkverträgen	Werkvertrag
Hildebrandt	Hildebrandt
Objektausstattung	Objektausstattung
Pro	pro
Arabien	Arabien
eigentumsähnlichen	eigentumsähnlichen
Gutachten	Gutachten
alle	alle
Baufertigteile	Baufertigteile
Marquart	Marquart
Markwart	Markwart
Einbezogen	einbeziehen
Feinbackwaren	Feinbackware
gilt	gelten
Zahntechniker	Zahntechniker
Mörtel	Mörtel
Grundvermögen	Grundvermögen
sein	sein
Münzner	Münzner
Datenaustauschs	Datenaustauschs
geführten	geführt
Pettka	Pettka
Storkow	Storkow
Frantz	Frantz
Bahntickets	Bahnticket
Nah	nahen
Transfer	Transfer
Zweigstellen	Zweigstellen
mittelbare	mittelbar
Events	Events
Vogt	Vogt
Gartenpflege	Gartenpflege
stellv.	stellv.
Eigentumswohnungen	Eigentumswohnung
abberufen	abberufen
kleinen	klein
Holzschutz	Holzschutz
Schaffung	Schaffung
Werner	Werner
Grundstückseigentümer	Grundstückseigentümer
vorgefertigten	vorgefertigt
natürlicher	natürlich
Aufträgen	Auftrag
Approbationen	Approbationen
Dachdeckerhandwerk	Dachdeckerhandwerk
auftragsbezogene	auftragsbezogene
Sämtliche	Sämtliche
bestehende	bestehend
Zugrundelegung	Zugrundelegung
Krauss	Krauss
Wuppertal	Wuppertal
Organisation	Organisation
Schneider	Schneider
gebrauchter	gebraucht
schlüsselfertige	schlüsselfertig
Fernverkehr	Fernverkehr
Bezüglich	bezüglich
Eigentum	Eigentum
Katar	Katar
Ihle	Ihle
Personalberatung	Personalberatung
transport	Transport
Brandschutztüren	Brandschutztüren
Rudski	Rudski
Elektrowerkzeugen	Elektrowerkzeugen
ambulanten	ambulant
Klooster	Klooster
Mommert	Mommert
Grauel	Grauel
fallenden	fallend
Bettina	Bettina
Möbelstoffen	Möbelstoff
AO	AO
Boller	Boller
Branislav	Branislav
Kabeltechnik	Kabeltechnik
Gerson	Gerson
Eckental	Eckental
weitestem	weitestem
verfahren	verfahren
Guß	Guß
Rh.	Rh.
alleinigen	alleinig
Stellmacher	Stellmacher
Nowak	Nowak
Desgleichen	desgleichen
Einzelvertretungsbefugnis	Einzelvertretungsbefugnis
führen	führen
Ververs	Ververs
Umsetzung	Umsetzung
siebzigste	siebzigst
Merx	Merx
Datenverarbeitungstechnik	Datenverarbeitungstechnik
Andreovits	Andreovits
Speditionsgeschäften	Speditionsgeschäften
Stadthafens	Stadthafens
Kipka	Kipka
Frachtführer	Frachtführer
sog.	sog.
besonderem	besonder
metallurgischen	metallurgischen
Grünanlagen	Grünanlage
Berlin	Berlin
lüftungstechnische	lüftungstechnische
Hochbauten	Hochbau
Schadstoffen	Schadstoff
Betonsanierung	Betonsanierung
Filmrechthandel	Filmrechthandel
sensibel	sensibel
Aktien	Aktie
ICB	ICB
je	je
Anlagenberatungs	Anlagenberatungs
Weiterverwertung	Weiterverwertung
Lina	Lina
N.	N.
Magazinen	Magazin
Berthold	Berthold
Grzimek	Grzimek
Einzelprokura	Einzelprokura
Luxembourgeoise	Luxembourgeoise
Dreieich	Dreieich
verwendet	verwenden
nichtöffentlichen	nichtöffentlich
Basare	Basar
medialen	medialen
Prokuristin	Prokuristin
Julia	Julia
Ausschreibung	Ausschreibung
Handelsgeschäfte	Handelsgeschäft
Bauberatungs	Bauberatungs
Betonbohrarbeiten	Betonbohrarbeiten
Spielplätzen	Spielplatz
August	August
Verleihkarts	Verleihkarts
Zabelitz	Zabelitz
Zur	zur
Servicestätten	Servicestätten
Mitgliedern	Mitglied
Abwasseranlagen	Abwasseranlage
Geschäftsausstattungen	Geschäftsausstattungen
Fernneuendorf	Fernneuendorf
Estrich	Estrich
Sonderkonstruktionen	Sonderkonstruktionen
Bereichen	Bereich
Kostehim	Kostehim
Litzkow	Litzkow
übertragenden	übertragend
Dara	Dara
Eisdielen	Eisdiele
Sachsen	Sachse
Riese	Riese
erbracht	erbringen
Baumaßnahmen	Baumaßnahme
Bundesanzeiger	Bundesanzeiger
September	September
Personenkraft	Personenkraft
Catering	Catering
historischer	historisch
Gieseler	Gieseler
Naturwaren	Naturware
Vergleichen	Vergleichen
Hemmingen	Hemmingen
Projektberatung	Projektberatung
CLP	CLP
Auf	auf
ökologischer	ökologischer
Ragösen	Ragösen
Facility	Facility
Halb	halb
Teppichwelt	Teppichwelt
Maschinenbau	Maschinenbau
Stellung	Stellung
Hilfeleistung	Hilfeleistung
stangen	Stange
Immobilienfonds	Immobilienfonds
Sanitärbranche	Sanitärbranche
Steinbrüchen	Steinbruch
ten	ten
Gottfried	Gottfried
Modeartikeln	Modeartikeln
Patolla	Patolla
Tischlerei	Tischlerei
Produktionen	Produktion
Arbeitsleistungen	Arbeitsleistung
Wind	Wind
Riedijk	Riedijk
Esterwegen	Esterwegen
Hörstel	Hörstel
kaufmännische	kaufmännisch
Herstellung	Herstellung
Polsterreinigung	Polsterreinigung
Bettin	Bettin
Manuela	Manuela
Lisette	Lisette
tierische	tierisch
individueller	individuell
Bild	Bild
Heinrich	Heinrich
Malerarbeiten	Malerarbeiten
nutzendem	nutzendem
Berner	Berner
Neustadt	Neustadt
Werbeaufträgen	Werbeauftrag
Peschel	Peschel
Küddelsmann	Küddelsmann
Przigode	Przigode
Bonenberger	Bonenberger
Bauträgergeschäft	Bauträgergeschäft
Werbemittlung	Werbemittlung
Kennzeichen	Kennzeichen
Tief	Tief
Fach	Fach
Folger	folgern
Internetanwendungen	Internetanwendungen
Stemmer	Stemmer
optimal	optimal
Ökonom	Ökonom
Gust	Gust
gehörenden	gehörend
Dienst	Dienst
Läden	Laden
Wasseraufbereitungsanlagen	Wasseraufbereitungsanlage
Umweltverträglichkeitsstudien	Umweltverträglichkeitsstudien
Rücken	Rücken
doppelwandigen	doppelwandigen
Polat	Polat
Geschäftstätigkeiten	Geschäftstätigkeit
Finanzdienstleistungen	Finanzdienstleistung
Kommunalwald	Kommunalwald
Zweifamilienhäusern	Zweifamilienhaus
Multimedia	Multimedia
Technikböden	Technikböden
Anders	Anders
Immobilienprojektentwicklungsgesellschaft	Immobilienprojektentwicklungsgesellschaft
Chemikalien	Chemikalie
Lotz	Lotz
steuerrechtliche	steuerrechtlich
Weigl	Weigl
Betriebsmittel	Betriebsmittel
Centers	Centers
bedürfen	bedürfen
Legehennen	Legehenne
Betriebskosten	Betriebskosten
Vertriebs	Vertrieb
Laschinsky	Laschinsky
Nickel	Nickel
Meister	Meister
Schulen	Schulen
Kultur	Kultur
Victor	Victor
immobiliengleichen	immobiliengleichen
Stahl	Stahl
angestrebt	anstreben
Polyanskiy	Polyanskiy
abgedeckten	abgedeckt
Stehimbiss	Stehimbiss
Werbe	werben
Schlußvorschriften	Schlußvorschriften
Landschaftsschutzes	Landschaftsschutz
Internetproviderservice	Internetproviderservice
Schweigert	Schweigert
Bauentwicklung	Bauentwicklung
Blatt	Blatt
Silvia	Silvia
gezielte	gezielt
Geldbearbeitungsmaschinen	Geldbearbeitungsmaschinen
Wohlgemuth	Wohlgemuth
Niels	Niels
Kinnemann	Kinnemann
Maurerhandwerk	Maurerhandwerk
industrieller	industriell
Finanzierungsvermittlung	Finanzierungsvermittlung
Forstliches	Forstliches
bürgerlichen	bürgerlich
Berufsanfänger	Berufsanfänger
Indivo	Indivo
München	München
Enders	Enders
Variationen	Variation
Fertigungsmaschinen	Fertigungsmaschinen
Zarnowski	Zarnowski
Verkauf	Verkauf
Market	Market
Straßen	Straße
Firmen	Firmen
Bliesendorf	Bliesendorf
Höhe	Höhe
Ablauf	Ablauf
BCV	BCV
Souvenir	Souvenir
Verbänden	Verband
ganze	ganz
Dominik	Dominik
Funk	Funk
Altbausanierungen	Altbausanierung
Abrißarbeiten	Abrißarbeiten
Harry	Harry
Alasevic	Alasevic
Gesellschafterrechte	Gesellschafterrechte
Einzel	Einzel
ihre	ihr
Höhn	höhnen
galvanischen	galvanisch
Gasrohrbau	Gasrohrbau
Langerwisch	Langerwisch
digitale	digital
wohnraumschaffenden	wohnraumschaffenden
Saskia	Saskia
the	the
bisher	bisher
Hugo	Hugo
werden	werden
Hofheim	Hofheim
Ferienwohnungen	Ferienwohnung
Detlef	Detlef
Linke	Linke
Kontierung	Kontierung
Seniorenzentrum	Seniorenzentrum
Leistungsphase	Leistungsphase
ermächtigen	ermächtigen
Finsterwalder	Finsterwalder
Stahlkonstruktionen	Stahlkonstruktion
Heidepriem	Heidepriem
flüssigen	flüssig
Umbau	Umbau
Stammkapitals	Stammkapital
Giese	Giese
Häusern	Haus
Dirk	Dirk
Reisebedarfs	Reisebedarfs
bebaut	bebaut
Rott	Rott
Fahrzeug	Fahrzeug
vielsprachigen	vielsprachig
Steinberg	Steinberg
Minderheitsrechte	Minderheitsrechte
Spielhallen	Spielhallen
Mehmet	Mehmet
Alarm	Alarm
u.a.	u.a.
Kunst	Kunst
Pesönlich	Pesönlich
Energieoptimierungssystemen	Energieoptimierungssystemen
Niemegk	Niemegk
Vogelsdorf	Vogelsdorf
medienspezifischer	medienspezifischer
gemäß	gemäß
Kelch	Kelch
Kommanditgesellschaft	Kommanditgesellschaft
analogen	analog
Immobilienbetreuung	Immobilienbetreuung
Rütgerswerke	Rütgerswerke
Hilfs	Hilfs
Statik	Statik
Sacheinlage	Sacheinlage
Hohen	Hohe
Programmveranstaltern	Programmveranstalter
neunte	neunt
Organschaftsverhältnisses	Organschaftsverhältnisses
Kniesche	Kniesche
Betreiben	betreiben
Kleinke	Kleinke
Platen	Platen
Ahnatal	Ahnatal
Flensburg	Flensburg
Vermögensberatung	Vermögensberatung
Eisenbahnoberbau	Eisenbahnoberbau
Hoppegarten	Hoppegärten
Gewerbegebieten	Gewerbegebieten
durchführen	durchführen
Management	Management
Rohbauten	Rohbau
Pumpen	Pumpen
Strohmeyer	Strohmeyer
Beschaffung	Beschaffung
Patienten	Patient
Huisman	Huisman
nützlich	nützlich
Eppstein	Eppstein
Alfio	Alfio
Kommunikationsagentur	Kommunikationsagentur
Beetke	Beetke
denkmalgeschützter	denkmalgeschützt
Bramkamp	Bramkamp
Verwaltungen	Verwaltung
Zuschlagstoffen	Zuschlagstoffen
Reinigung	Reinigung
Polyäthylen	Polyäthylen
Bouché	Bouché
Infrastrukturmaßnahmen	Infrastrukturmaßnahme
Gewährung	Gewährung
Ferchesar	Ferchesar
personalen	personal
Siebte	Siebte
Dürr	Dürr
namentlich	namentlich
branchentypischen	branchentypisch
Kabel	Kabel
Berechnung	Berechnung
Nachrüstung	Nachrüstung
Simon	Simon
Filmbeteiligungsgesellschaft	Filmbeteiligungsgesellschaft
Klempner	Klempner
Herstellungsprozeß	Herstellungsprozeß
betroffenen	betroffen
mieten	mieten
Hahn	Hahn
Wettbewerb	Wettbewerb
Zweigniederlassungen	Zweigniederlassung
VEB	VEB
Oldenbostel	Oldenbostel
Online	Online
weiterveräußert	weiterveräußern
unbeschränkten	unbeschränkt
Umweltsanierungsvorhaben	Umweltsanierungsvorhaben
Rainer	Rainer
Demokratischen	Demokratische
Parkanlagen	Parkanlage
Ergebnis	Ergebnis
Hoch	Hoch
Erholungseinrichtungen	Erholungseinrichtung
Helmuth	Helmuth
maritimer	maritim
Sitz	Sitz
Roya	Roya
Hohenberg	Hohenberg
Straßenmarkierungen	Straßenmarkierung
Matziner	Matziner
Simonsen	Simonsen
Lohnbuchhaltung	Lohnbuchhaltung
Köster	Köster
Rostov	Rostov
Luxemburg	Luxemburg
zusammenhängende	zusammenhängend
Pletzinger	Pletzinger
Bearbeitung	Bearbeitung
Mainz	Mainz
Hagen	Hagen
Erstellen	Erstellen
Stefanie	Stefanie
Kraftfahrzeuggutachten	Kraftfahrzeuggutachten
wie	wie
Publikation	Publikation
allgemeine	allgemein
Publizierungen	Publizierungen
Molekularbiologie	Molekularbiologie
ergänzen	ergänzen
die	d
Israel	Israel
mast	Mast
binnen	binnen
sachlich	sachlich
Friedrichsruh	Friedrichsruh
Robert	Robert
Alsbach	Alsbach
Geschäften	Geschäft
Schinkenspezialitäten	Schinkenspezialitäten
Hengelo	Hengelo
Bähr	Bähr
Kommunikationselektronik	Kommunikationselektronik
Crispin	Crispin
Initiierung	Initiierung
Fortschritt	Fortschritt
Butze	Butze
Brehmer	Brehmer
Prototypen	Prototyp
Inhalte	Inhalt
tbg	tbg
kürzeren	kurz
Gentechnologie	Gentechnologie
Kurierdienst	Kurierdienst
Kadisch	Kadisch
Schmuckler	Schmuckler
Beier	Beier
Tankschutztechnik	Tankschutztechnik
Technikforschung	Technikforschung
Damelang	Damelang
Lubasch	Lubasch
Worms	Worms
Cineinnocent	Cineinnocent
Außerhausverrichtungen	Außerhausverrichtungen
Platten	Platten
Büroorganisation	Büroorganisation
einfache	einfach
verarbeitetem	verarbeitet
damit	damit
Steinmüller	Steinmüller
Bert	Bert
MediTrans	MediTrans
Moderation	Moderation
geb.	Geb.
Verwaltungsgesellschaft	Verwaltungsgesellschaft
Home	Home
Steger	Steger
steuerlicher	steuerlich
Reisende	Reisende
Metallbau	Metallbau
Hilter	Hilter
Jürgensen	Jürgensen
Stammer	Stammer
Morgenpost	Morgenpost
Funktion	Funktion
Beteiligungsverwaltung	Beteiligungsverwaltung
vertraglicher	vertraglich
Verwertungsrechte	Verwertungsrechte
Finanzgerichten	Finanzgericht
Kampowski	Kampowski
erbrachten	erbracht
YTONG	YTONG
ähnlicher	ähnlich
Kosmetikartikeln	Kosmetikartikel
Mentoring	Mentoring
Bradsch	Bradsch
auswerten	auswerten
Tabakwaren	Tabakware
nachweisen	nachweisen
Handelsgesellschaften	Handelsgesellschaft
Gefriererzeugnissen	Gefriererzeugnissen
Genehmigung	Genehmigung
Produktentwicklung	Produktentwicklung
Mügge	Mügge
Klimatechnik	Klimatechnik
Hünfelden	Hünfelden
Priske	Priske
Verputzarbeiten	Verputzarbeiten
Beschlussfassung	Beschlussfassung
steht	stehen
Rutte	Rutte
Datennetzen	Datennetz
audiovisuelle	audiovisuell
Martinus	Martinus
Steinfeld	Steinfeld
Goetze	Goetze
Muhs	Muhs
Miethke	Miethke
Anwendungsberatung	Anwendungsberatung
Gesellschafterversammlung	Gesellschafterversammlung
Jugendhilfegesetzes	Jugendhilfegesetz
verwalten	verwalten
Einzelprokurist	Einzelprokurist
geeigneten	geeignet
Vermehrungsbetrieb	Vermehrungsbetrieb
Verkaufsstellen	Verkaufsstellen
Einrichtungselementen	Einrichtungselementen
Bäckerei	Bäckerei
Gleichzeitig	gleichzeitig
Lüftungstechnik	Lüftungstechnik
logistische	logistisch
ROM	ROM
Aktionäre	Aktionär
hiermit	hiermit
Imbiß	Imbiß
gewährende	gewährend
Tennisturnieren	Tennisturnieren
Beteiligungen	Beteiligung
Rosentritt	Rosentritt
Fortbildungs	Fortbildungs
Blumen	Blume
Sparkassenverordnung	Sparkassenverordnung
Pausin	Pausin
FSPE	FSPE
Weißputzarbeiten	Weißputzarbeiten
Fortbildung	Fortbildung
Frachtvermittlung	Frachtvermittlung
Schlosser	Schlosser
Hilfsbetrieb	Hilfsbetrieb
Oleg	Oleg
Kubasch	Kubasch
Penzlin	Penzlin
Digwa	Digwa
Rudi	Rudi
Liquidator	Liquidator
Medienberatung	Medienberatung
Goering	Goering
angeregt	anregen
Außenhandelskaufmann	Außenhandelskaufmann
Gaderkesee	Gaderkesee
Research	Research
Vorgenannten	vorgenannt
Gebäudereinigerarbeiten	Gebäudereinigerarbeiten
Elektroingenieur	Elektroingenieur
Ablesung	Ablesung
Objektschutzmaßnahmen	Objektschutzmaßnahme
sportlich	sportlich
Bauangelegenheiten	Bauangelegenheit
Entwicklungen	Entwicklung
Gundula	Gundula
Jesch	Jesch
Prochno	Prochno
INFRA	INFRA
innovativen	innovativ
Miet	Miet
Verschleißteilen	Verschleißteilen
Thiede	Thiede
Weiß	Weiß
Heßberg	Heßberg
Klassen	Klasse
psychisch	psychisch
Gregor	Gregor
Unternehmensgegenstand	Unternehmensgegenstand
soweit	soweit
Mitvertretungsberechtigte	Mitvertretungsberechtigte
Steudte	Steudte
Clearingdienstleistungen	Clearingdienstleistungen
Trailer	Trailer
gewonnenen	gewonnen
Oberbodenarbeiten	Oberbodenarbeiten
Fernsehproduktionssystemen	Fernsehproduktionssystemen
Alon	Alon
Seel	Seel
Sportforums	Sportforum
d.h.	d.h.
Modernisierungs	Modernisierungs
Hardware	Hardware
be	be
elektrische	elektrisch
Filmaufnahmen	Filmaufnahme
Medienverfahren	Medienverfahren
Auftraggeber	Auftraggeber
A&O	A&O
Bauwerkzeugen	Bauwerkzeugen
Sponsorenbetreuung	Sponsorenbetreuung
Wuntke	Wuntke
Eschwege	Eschweg
hält	halten
Bauträger	Bauträger
Sabine	Sabine
Dies	dies
Duchow	Duchow
k	K
Marktfruchtbaubetriebes	Marktfruchtbaubetriebes
Großhandels	Großhandel
Erbbaurechtes	Erbbaurechtes
städtischen	städtisch
Geotechnik	Geotechnik
Unterlagen	Unterlage
An	an
Untersuchungsergebnissen	Untersuchungsergebnis
Projektsteuerungsleistungen	Projektsteuerungsleistungen
eigenwirtschaftliche	eigenwirtschaftlich
glaubhaft	glaubhaft
sechs	sechs
Christianus	Christianus
Planen	Planen
Maurerhandwerks	Maurerhandwerks
Steuerberatung	Steuerberatung
Spielzeug	Spielzeug
hydraulisch	hydraulisch
Sanitärinstallationsarbeiten	Sanitärinstallationsarbeiten
Eignungsnachweises	Eignungsnachweises
Kufeld	Kufeld
Wrege	Wrege
Fernsehprogrammen	Fernsehprogramm
Stuckenbrok	Stuckenbrok
Assenmacher	Assenmacher
Hohlmeier	Hohlmeier
Rohr	Rohr
Erwachsenenbereich	Erwachsenenbereich
Hebert	Hebert
Kunstleder	Kunstleder
Nachgründung	Nachgründung
Marktaktivitäten	Marktaktivität
Straube	Straube
Gnewkow	Gnewkow
Vogel	Vogel
Aufzugsanlagen	Aufzugsanlage
Pauschalreisen	Pauschalreisen
Stahlbau	Stahlbau
Schrottannahme	Schrottannahme
Funkanbindungen	Funkanbindungen
Transport	Transport
Büchern	Buch
Saudi	Saudi
Sechst	sechst
Kriminalrat	Kriminalrat
Bühring	Bühring
Lanitz	Lanitz
Fliesenarbeiten	Fliesenarbeiten
Kulle	Kulle
Erbringen	erbringen
Wert	Wert
Vermittlungen	Vermittlung
Datenverarbeitungsanwendern	Datenverarbeitungsanwendern
GRUNDCONSULT	GRUNDCONSULT
Nicklisch	Nicklisch
Beschränkungen	Beschränkung
Spindler	Spindler
Dienstleistungsbüro	Dienstleistungsbüro
Fernsehbeiträge	Fernsehbeitrag
Schalung	Schalung
RCM	RCM
Sozialarbeitern	Sozialarbeiter
Hauptprodukten	Hauptprodukten
Biochemie	Biochemie
Bombal	Bombal
Presseerzeugnissen	Presseerzeugnis
Gesamtheit	Gesamtheit
Möglichkeiten	Möglichkeit
Abfallwirtschaftskonzepte	Abfallwirtschaftskonzept
Prietz	Prietz
infrastruktureller	infrastrukturell
Untervertretern	Untervertretern
bietet	bieten
Pflanzarbeiten	Pflanzarbeiten
Hilfsmitteln	Hilfsmitteln
Oberhausen	Oberhausen
klassische	klassisch
Medizingeräten	Medizingeräten
Feucht	feucht
Kotlowski	Kotlowski
Fondsbeteiligungen	Fondsbeteiligungen
Hausbau	Hausbau
Elementen	Element
Reiseveranstalter	Reiseveranstalter
immobilien	Immobilie
MAN	MAN
Gabriel	Gabriel
Auftragsschweißungen	Auftragsschweißungen
Bauvorhaben	Bauvorhaben
Nachschlagewerken	Nachschlagewerk
Im	im
Hanau	Hanau
innen	innen
Rossini	Rossini
Baustofftransports	Baustofftransports
Libanon	Libanon
Bimmler	Bimmler
frei	frei
nachbereitenden	nachbereitenden
Erzeugnisse	Erzeugnis
Staub	Staub
Betonstahl	Betonstahl
Freizeitparks	Freizeitpark
Firma	Firma
Modellbau	Modellbau
gesch.	gesch.
Meyfarth	Meyfarth
Aufträge	Auftrag
KROEBO	KROEBO
Weißwasser	Weißwasser
Automobilersatzteilen	Automobilersatzteilen
Roger	Roger
Unteraufträgen	Unterauftrag
Beteiligung	Beteiligung
Wasser	Wasser
gesellschaftseigenen	gesellschaftseigen
Schwerin	Schwerin
mehrere	mehrere
Wossilius	Wossilius
u.	um
beanspruchen	beanspruchen
Sandstrahlen	Sandstrahlen
Valérie	Valérie
Bedarf	Bedarf
Ingenpass	Ingenpass
S.A.	S.A.
Generalbauunternehmen	Generalbauunternehmen
ehem.	ehem.
Performences	Performences
Rettler	Rettler
Studenten	Student
Dipl.-Bauingenieurin	Dipl.-Bauingenieurin
Bauberatung	Bauberatung
Sicherheitsbeauftragter	Sicherheitsbeauftragte
Radosavljevic	Radosavljevic
Wärmemengen	Wärmemengen
dazu	dazu
Bewirtschaften	Bewirtschaften
Zahnarzt	Zahnarzt
Hoier	Hoier
TVM	TVM
handelnd	handelnd
Versicherungsagentur	Versicherungsagentur
Blücher	Blücher
regelmäßigen	regelmäßig
hochqualifizierter	hochqualifiziert
Hansjörg	Hansjörg
Adolf	Adolf
zahnärztlichem	zahnärztlichem
Wolfram	Wolfram
Seppo	Seppo
Rohrleitungs	Rohrleitungs
Endmontage	Endmontage
tierischen	tierisch
Apel	Apel
Erschließungsmaßnahmen	Erschließungsmaßnahme
geschäftsführende	geschäftsführend
Filmprojekten	Filmprojekt
Holzgewerbe	Holzgewerbe
Dipl.Wirt	Dipl.Wirt
Authoring	Authoring
Architekt	Architekt
Reimann	Reimann
Matthäi	Matthäi
Oman	Oman
Dachbegrünung	Dachbegrünung
Frydling	Frydling
Isernhagen	Isernhagen
Degen	Degen
Kraftfahrzeuge	Kraftfahrzeug
Wernsdorf	Wernsdorf
Frederking	Frederking
sollen	sollen
Biotopen	Biotop
Persike	Persike
Weißenborn	Weißenborn
Trans	Tran
Zeit	Zeit
Finanzmanagement	Finanzmanagement
wesentlichen	wesentlich
Hubertus	Hubertus
Fototechnik	Fototechnik
Hillwig	Hillwig
Rohholzgewinnung	Rohholzgewinnung
Delmenhorst	Delmenhorst
handwerksmäßige	handwerksmäßige
Druckerzeugnissen	Druckerzeugnis
Dekoration	Dekoration
verzeichnet	verzeichnen
Klier	Klier
letztmalig	letztmalig
Maklergeschäfte	Maklergeschäfte
Lizenzrechten	Lizenzrechten
Pluton	Pluton
Wahl	Wahl
Kremmen	Kremmen
PC	PC
amerikanischer	amerikanisch
bereits	bereits
Kanalbau	Kanalbau
aufgehoben	aufheben
Party	Party
Starnberg	Starnberg
Trier	Trier
Außenwirtschaft	Außenwirtschaft
Hinterhöfen	Hinterhof
Luft	Luft
Teilfläche	Teilfläche
jede	jed
elektronic	elektronic
Krawczyk	Krawczyk
Forschungs	Forschungs
Als	als
Theilemann	Theilemann
Geschäftsgegenstand	Geschäftsgegenstand
Ulrich	Ulrich
Preuß	Preuß
Saunabetrieb	Saunabetrieb
türkischem	türkisch
haftender	haftend
Holzsanierungsarbeiten	Holzsanierungsarbeiten
Finsterwalde	Finsterwald
MB	MB
betreibt	betreiben
Wartenberg	Wartenberg
Erich	Erich
ersten	erst
vorstellen	vorstellen
Elektromeister	Elektromeister
Gewerbe	Gewerbe
Geschke	Geschke
Güssow	Güssow
Projektleitungen	Projektleitungen
Anton	Anton
Projekten	Projekt
Sachverständiger	Sachverständige
Ostbevern	Ostbevern
B5	B5
Pahl	Pahl
Reuterstadt	Reuterstadt
Finanztechnische	finanztechnisch
elektronisch	elektronisch
Franchise	Franchise
Medienökonomie	Medienökonomie
Bankkauffrau	Bankkauffrau
Heizungsbauarbeiten	Heizungsbauarbeiten
Neubert	Neubert
Effekte	Effekt
Gütern	Gut
jeder	jed
Lastkraftwagen	Lastkraftwagen
Noack	Noack
Brita	Brita
Raumausstattungseinrichtungen	Raumausstattungseinrichtungen
Ludwig	Ludwig
Reimer	Reimer
Anlagemöglichkeiten	Anlagemöglichkeit
Güternahverkehr	Güternahverkehr
g.	g.
Kussauer	Kussauer
Bürodienstleistungen	Bürodienstleistungen
Frankenfelder	Frankenfelder
eCommerce	eCommerce
Nutzungsberechtigten	Nutzungsberechtigte
Werkstatt	Werkstatt
Handelsbereich	Handelsbereich
Abnehmer	Abnehmer
Alexandre	Alexandre
Gerd	Gerd
Zahnersatz	Zahnersatz
organischen	organisch
Dachau	Dachau
Zernick	Zernick
Einkaufsgemeinschaften	Einkaufsgemeinschaften
Wireless	Wireless
Fahrland	Fahrland
Pabst	Pabst
Metall	Metall
Umzugsverkehr	Umzugsverkehr
Los	los
vorhanden	vorhanden
Fohrde	Fohrde
Lehnin	Lehnin
herrschendem	herrschendem
außerdem	außerdem
Sammeln	Sammeln
Filmproduktionsgesellschaft	Filmproduktionsgesellschaft
Wohlfahrt	Wohlfahrt
Bestellung	Bestellung
Trägervereins	Trägerverein
Flächensanierung	Flächensanierung
maschinellen	maschinell
Potsdam	Potsdam
Frigge	Frigge
Medientechnologien	Medientechnologie
Auftragsforschung	Auftragsforschung
Düngestoffen	Düngestoffen
Bornemann	Bornemann
Zerfowski	Zerfowski
Verbindung	Verbindung
gleichem	gleich
Liebenthal	Liebenthal
Agentur	Agentur
verbrieften	verbrieften
Analysen	Analyse
daß	daß
Medienwirtschaft	Medienwirtschaft
logistischer	logistisch
Restaurants	Restaurant
unter	unter
Burg	Burg
zwecks	zwecks
Rühlicke	Rühlicke
Pioch	Pioch
Automobilindustrie	Automobilindustrie
Hehn	Hehn
vergeben	vergeben
Frankenpost	Frankenpost
Kompostierung	Kompostierung
Kordus	Kordus
Ausnahme	Ausnahme
Diamantwerkzeugen	Diamantwerkzeugen
Elternarbeit	Elternarbeit
Außerdem	außerdem
Sponsoren	Sponsor
Befördern	Befördern
BAG	BAG
Zargen	Zargen
Königs	Königs
Epimetheus	Epimetheus
Ausbauten	Ausbau
Weiland	weiland
angeschlossenem	angeschlossen
Weyde	Weyde
Straßenzuschlagstoffen	Straßenzuschlagstoffen
Hohenschönhausen	Hohenschönhausen
Wermelskirchen	Wermelskirchen
Claudia	Claudia
Beherbergungsgewerbes	Beherbergungsgewerbe
Projektleistungen	Projektleistungen
Medi	Medi
Dienstleistungsunternehmen	Dienstleistungsunternehmen
Weitere	weit
zuvor	zuvor
Vollwärmeschutzmaterialien	Vollwärmeschutzmaterialien
printware	printware
Abwasser	Abwasser
vermitteln	vermitteln
Gassicherheitstechnik	Gassicherheitstechnik
Peripherie	Peripherie
Karl	Karl
Reparaturarbeiten	Reparaturarbeiten
Sozialpädagogen	Sozialpädagoge
Polstermöbeln	Polstermöbeln
überwachen	überwachen
Hochbildsystemen	Hochbildsystemen
Baubetreuer	Baubetreuer
Muszynski	Muszynski
Seniorenresidenz	Seniorenresidenz
der	d
Wartungsaufträgen	Wartungsaufträgen
Audiogeräte	Audiogeräte
Direktansprache	Direktansprache
Gunga	Gunga
Hude	Hude
Gemeinnützigkeit	Gemeinnützigkeit
Umstrukturierung	Umstrukturierung
Betreiber	Betreiber
Leo	Leo
Buchhaltung	Buchhaltung
Forschung	Forschung
Laub	Laub
öffentlichen	öffentlich
Grenzen	Grenzen
Renate	Renate
Plosig	Plosig
darf	dürfen
Alle	alle
Deutschmann	Deutschmann
Jörn	Jörn
Feldsaaten	Feldsaaten
Immundiagnostika	Immundiagnostika
Bewirtung	Bewirtung
Balkonverkleidungen	Balkonverkleidungen
Er	er
Lackierung	Lackierung
Kablow	Kablow
Managements	Management
Sozialdienstes	Sozialdienst
zugestimmt	zustimmen
Programmerstellung	Programmerstellung
Bauwerkserhaltung	Bauwerkserhaltung
Kristof	Kristof
Wilhelmshorst	Wilhelmshorst
landwirtschaftlich	landwirtschaftlich
dieses	dies
Erfordernissen	Erfordernis
Röseler	Röseler
Geschäftsjahr	Geschäftsjahr
Astrid	Astrid
kaufmännischen	kaufmännisch
Brieselang	Brieselang
Kleinausstattung	Kleinausstattung
moderner	modern
Eigenhändler	Eigenhändler
Einführung	Einführung
Steuerberater	Steuerberater
Heizungs	Heizungs
abgestimmten	abgestimmt
gemeinsam	gemeinsam
Wohnanlagen	Wohnanlage
Tabouret	Tabouret
Baugewerbes	Baugewerbe
Niederlassung	Niederlassung
Plattenwerkstoffen	Plattenwerkstoffen
dafür	dafür
Meinungsforschungsstudien	Meinungsforschungsstudien
Bergisch	bergisch
Umzugsfernverkehr	Umzugsfernverkehr
Auto	Auto
a.	a.
wirksam	wirksam
Osteuropa	Osteuropa
Buchal	Buchal
Dipl.-Kfm.	Dipl.-Kfm.
Kai	Kai
Steuerrechts	Steuerrecht
Industriezweige	Industriezweig
Du	du
Gründer	Gründer
Dehmel	Dehmel
p.a.	p.a.
Wegendorf	Wegendorf
Schomacker	Schomacker
Transporteinrichtungen	Transporteinrichtung
Arbeitsplätze	Arbeitsplatz
Projektierungsleistungen	Projektierungsleistungen
Filmwerken	Filmwerken
Braun	Braun
Heisterhagen	Heisterhagen
Sanitärmontagen	Sanitärmontagen
Aluminium	Aluminium
Sohn	Sohn
beim	beim
Kommunikationslösungen	Kommunikationslösungen
Aufsichtsrat	Aufsichtsrat
Betreuung	Betreuung
Demert	Demert
ISO	ISO
Walsleben	Walsleben
Krediten	Kredit
Roberto	Roberto
Vermarktung	Vermarktung
HiFi	HiFi
Haker	Haker
gleiche	gleich
Ladenflächen	Ladenfläche
fördern	fördern
Willert	Willert
Braunschweig	Braunschweig
Berg	Berg
begründet	begründen
Meier	Meier
Fahrzeugteilen	Fahrzeugteilen
prägende	prägend
Videocassetten	Videocassetten
Film	Film
Methgal	Methgal
Klima	Klima
Nauen	Nauen
Zaunbau	Zaunbau
Stammkaptial	Stammkaptial
vegetativen	vegetativ
gründenden	gründend
Klüh	Klüh
Einzelhandel	Einzelhandel
Bauschutt	Bauschutt
i	I
Geschäftsführungsgesellschaft	Geschäftsführungsgesellschaft
Liscsinszky	Liscsinszky
systemen	System
Vorzugsaktien	Vorzugsaktie
Stubbe	Stubbe
Ullrich	Ullrich
Ladengeschäfte	Ladengeschäft
Sicherheitsgebiet	Sicherheitsgebiet
Anwendungsbereiche	Anwendungsbereich
Weisenbilder	Weisenbilder
Badstudios	Badstudios
Sanitärarbeiten	Sanitärarbeiten
Kuhlke	Kuhlke
einzelvertretungsberechtigte	einzelvertretungsberechtigte
Maxim	Maxim
Münch	Münch
Leistungsschutzrechten	Leistungsschutzrechten
touristische	touristisch
Ausführen	Ausführen
Lüftungs	Lüftungs
Mineralien	Mineral
Edelstahl	Edelstahl
bespielt	bespielen
Absatzgruben	Absatzgruben
ganztägigen	ganztägig
Entsorgen	Entsorgen
Istanbul	Istanbul
Ingenieure	Ingenieur
Standorte	Standort
Gräbendorf	Gräbendorf
zählen	zählen
Königsmann	Königsmann
Schallschutzisolierung	Schallschutzisolierung
ihnen	sie
Gleichfeld	Gleichfeld
Angelika	Angelika
Gaedke	Gaedke
Albrecht	Albrecht
Gewerbegebiet	Gewerbegebiet
Dürbeck	Dürbeck
Christoph	Christoph
ab	ab
Wiebke	Wiebke
Anmeldung	Anmeldung
Erika	Erika
Landschaftsbau	Landschaftsbau
Samato	Samato
entwicklungstechnischer	entwicklungstechnischer
Schmude	Schmude
Main	Main
Bernhard	Bernhard
Hacker	Hacker
Ungarn	Ungarn
Bekanntheitsgrades	Bekanntheitsgrad
Ernicke	Ernicke
hat	haben
gewerbsmäßigen	gewerbsmäßig
Inland	Inland
Komplementärgesellschaft	Komplementärgesellschaft
führer	Führer
bedarf	bedarf
Emil	Emil
Präzisionsfertigung	Präzisionsfertigung
Gesellschaftsvertrag	Gesellschaftsvertrag
Gemeinschaftsproduktionen	Gemeinschaftsproduktion
Detektei	Detektei
technologie	Technologie
Vorsitzender	vorsitzend
Alfdorf	Alfdorf
Österwitz	Österwitz
Gesellschaftsvertrages	Gesellschaftsvertrag
gehört	gehören
Brennstoffen	Brennstoff
Gebäuden	Gebäude
Baustahl	Baustahl
Spreenhagen	Spreenhagen
Mario	Mario
Görtz	Görtz
Kostic	Kostic
gewerbsmässige	gewerbsmässige
Ildikó	Ildikó
Industriereinung	Industriereinung
Frischbeton	Frischbeton
Bertz	Bertz
sonstigen	sonstig
Flächen	Fläche
Andre	Andre
gewerbsmäßig	gewerbsmäßig
Werterhaltung	Werterhaltung
V	V
Beratung	Beratung
Alleinvertretungsbefugnis	Alleinvertretungsbefugnis
Jacht	Jacht
Dorrit	Dorrit
Mittagsmenüs	Mittagsmenüs
Konstruktion	Konstruktion
Hamburg	Hamburg
Speditionskaufmann	Speditionskaufmann
Casting	Casting
Angehörige	Angehörige
Tickets	Ticket
Lütte	Lütte
Korte	Korte
Miesenbach	Miesenbach
Tischlerarbeiten	Tischlerarbeiten
Brünsche	Brünsche
tätig	tätig
Export	Export
selbst	selbst
Ingenieur	Ingenieur
Lohnarbeit	Lohnarbeit
Schmalor	Schmalor
Engels	Engels
Reha	Reha
Sattelberg	Sattelberg
Arbeitsvermittlung	Arbeitsvermittlung
Zweck	Zweck
Maletzki	Maletzki
Kommunikationskonzepte	Kommunikationskonzepte
Münzen	Münzen
Schwedler	Schwedler
Verbreitung	Verbreitung
Senden	Senden
Fennen	Fennen
Erzeugungs	Erzeugungs
entstandenen	entstanden
Binder	Binder
unmittelbare	unmittelbar
Wandlitz	Wandlitz
explosionsgeschützten	explosionsgeschützt
Einfuhr	Einfuhr
Innenräume	Innenraum
Alt	Alt
kosmetischer	kosmetisch
CE	CE
Pensionen	Pension
Velten	Velten
Nennbetrag	Nennbetrag
Budapest	Budapest
Nenneker	Nenneker
Strausberg	Strausberg
Konzack	Konzack
Schleef	Schleef
nationale	national
kommunale	kommunal
Leif	Leif
Großen	Große
mehreren	mehrere
erzieherischer	erzieherisch
Mittag	Mittag
Fassadenverkleidungen	Fassadenverkleidung
Immobilienprojekten	Immobilienprojekt
Sportplatzbau	Sportplatzbau
Ibbenbüren	Ibbenbüren
gen.	gen.
bezeichneten	bezeichnet
Qualitätsregeln	Qualitätsregeln
Schulungsmaßnahmen	Schulungsmaßnahme
Pfaff	Pfaff
Betriebswirtin	Betriebswirtin
Spaltungsbeschluß	Spaltungsbeschluß
Lupp	Lupp
Sieber	Sieber
Schaufensteranlagen	Schaufensteranlagen
Restposten	Restposten
WUP	WUP
Giszas	Giszas
stehen	stehen
Fachberatung	Fachberatung
Joseph	Joseph
Baukoordinierung	Baukoordinierung
Auftragnehmer	Auftragnehmer
Laubinger	Laubinger
benachteiligte	benachteiligt
Gesellschaftern	Gesellschafter
Affing	Affing
Kreissparkasse	Kreissparkasse
Tagesspiegel	Tagesspiegel
Brückenbauten	Brückenbau
Geschäftsgrundstücken	Geschäftsgrundstücken
Lebensmitteln	Lebensmitteln
Fredenbeck	Fredenbeck
Lebensmittelzusatzstoffen	Lebensmittelzusatzstoff
Aufbauorganisation	Aufbauorganisation
fernverkehr	Fernverkehr
eintreten	eintreten
Gaby	Gaby
Übernachtung	Übernachtung
Sande	Sand
Immo	Immo
Beginn	Beginn
Von	von
Jeder	jed
Public	Public
Gewerbeflächen	Gewerbefläche
Frey	Frey
Vermietungen	Vermietung
Luckenwalde	Luckenwalde
Ralf	Ralf
Schneeberäumung	Schneeberäumung
Hubert	Hubert
Darüber	darüber
Hürth	Hürth
Verpackungsanlagen	Verpackungsanlagen
Kuwait	Kuwait
Rhein	Rhein
Kirner	Kirner
Gertrud	Gertrud
Chevrolet	Chevrolet
Publizistik	Publizistik
Kurzzeitpflegeeinrichtung	Kurzzeitpflegeeinrichtung
Umweltbetriebsprüfungen	Umweltbetriebsprüfungen
Ausstattungsgegenständen	Ausstattungsgegenständen
Unterhaltungsgastronomie	Unterhaltungsgastronomie
zustimmenden	zustimmend
Qualifizierungs	Qualifizierungs
RUTEC	RUTEC
Sach	Sach
Recklinghausen	Recklinghausen
gärtnerisch	gärtnerisch
Versicherungsmakler	Versicherungsmakler
Schneidersöhne	Schneidersöhne
Durch	durch
ordentliches	ordentlich
nur	nur
jeweiligen	jeweilig
Wurstwaren	Wurstware
HRB	HRB
unbearbeitetem	unbearbeitetem
Bauleitung	Bauleitung
Hörfunkprogrammen	Hörfunkprogramm
Glasreinigung	Glasreinigung
Einkaufszentren	Einkaufszentrum
Böhme	Böhme
Marketingbereich	Marketingbereich
Stahlbeton	Stahlbeton
Bauarbeiten	Bauarbeiten
Bodenbearbeitung	Bodenbearbeitung
Rüsch	Rüsch
AV	AV
Fahrscheinen	Fahrscheinen
formwechselnden	formwechselnden
Sanitärinstallation	Sanitärinstallation
Pressevertriebs	Pressevertrieb
Gewerken	Gewerken
Skalicky	Skalicky
Ablesen	Ablesen
Keßler	Keßler
Handlungen	Handlung
Züchtung	Züchtung
Diekert	Diekert
Wirtschaftswissenschaftler	Wirtschaftswissenschaftler
Wohneinheiten	Wohneinheit
Sonntag	Sonntag
Damm	Damm
Toleranz	Toleranz
Hecht	Hecht
Hilfen	Hilfe
bedingte	bedingt
Blockhaus	Blockhaus
Venture	Venture
Schweißkonstruktionen	Schweißkonstruktionen
Magdeburger	Magdeburger
verbundene	verbunden
e.V.	e.V.
Grötzinger	Grötzinger
Reiseartikeln	Reiseartikeln
belasteten	belastet
Jens	Jens
Mertens	Mertens
Bausubstanz	Bausubstanz
Gottlieb	Gottlieb
denselben	denselben
Erdbau	Erdbau
Aslan	Aslan
Datenservice	Datenservice
Nuthe	Nuthe
Metallerzeugnissen	Metallerzeugnissen
Erhöhung	Erhöhung
Wohnbereich	Wohnbereich
Bäckereigeschäften	Bäckereigeschäften
Flüssiggas	Flüssiggas
Lamcha	Lamcha
Ferntransporten	Ferntransporten
allgemein	allgemein
Dietersdorf	Dietersdorf
Geschäftsführung	Geschäftsführung
Fertigproduktion	Fertigproduktion
Tietzow	Tietzow
herrschende	herrschend
VPG	VPG
eingeschlossen	eingeschlossen
Werbezeiten	Werbezeit
Wohnungen	Wohnung
Veranstaltungen	Veranstaltung
beziehungsweise	beziehungsweise
Verarbeitung	Verarbeitung
Unternehmungen	Unternehmung
Lück	Lück
Rosmalen	Rosmalen
ökologischen	ökologisch
Bernd	Bernd
planerischer	planerischer
Mönch	Mönch
unbeschränkter	unbeschränkt
design	Design
Stierand	Stierand
Erschließungsarbeiten	Erschließungsarbeiten
Biohäuser	Biohäuser
Rechtsanwältin	Rechtsanwältin
Bauträgerverordnung	Bauträgerverordnung
Medienrecht	Medienrecht
Geschäftsinhabers	Geschäftsinhaber
Dämmarbeiten	Dämmarbeiten
festgestellt	feststellen
sportmedizinischen	sportmedizinisch
Briesen	Bries
Informationsbereitstellungen	Informationsbereitstellungen
Unternehmenszweckes	Unternehmenszweckes
Anbieten	Anbieten
Elektromaschinen	Elektromaschine
Balski	Balski
Kanalreinigungs	Kanalreinigungs
Möbeln	Möbeln
Büroservice	Büroservice
Elektrotechnik	Elektrotechnik
Schriftstücke	Schriftstücke
Bürobedarf	Bürobedarf
GewO	GewO
Poppe	poppen
Bündelung	Bündelung
Marktbearbeitung	Marktbearbeitung
Helga	Helga
Bauerrichtung	Bauerrichtung
Innovations	Innovations
Stellert	Stellert
empirische	empirisch
SAB	SAB
Dipl.-Kaufm	Dipl.-Kaufm
Reisen	Reisen
Schröer	Schröer
Jugendfreizeitzentrums	Jugendfreizeitzentrum
Fischer	Fischer
Oedenrode	Oedenrode
Wullen	Wullen
Lattmann	Lattmann
Dipl.-Chemiker	Dipl.-Chemiker
Anwendersoftware	Anwendersoftware
einzeln	einzeln
T.	T.
Produktion	Produktion
ähnlichen	ähnlich
Kunststoffolien	Kunststoffolie
TV	TV
ersatzlos	ersatzlos
Vorstandsvorsitzender	Vorstandsvorsitzende
Fuhrmann	Fuhrmann
Serienproduktion	Serienproduktion
Motorentechnik	Motorentechnik
Search	Search
demselben	demselben
Verarbeiten	Verarbeiten
Elektrotechnischen	Elektrotechnische
Jovanovic	Jovanovic
Folgeprodukten	Folgeprodukt
Rohrleitungsbau	Rohrleitungsbau
Bauwesens	Bauwesen
Vestrup	Vestrup
Sortierung	Sortierung
Marius	Marius
Niederlande	Niederlande
Landesrecht	Landesrecht
betreutes	betreut
Schupp	Schupp
Biohäusern	Biohäusern
aufgelöst	auflösen
Vereine	Verein
Heinersdorf	Heinersdorf
Kommunikationssystemen	Kommunikationssystem
Hölzern	Holz
allgemeiner	allgemein
schlüsselfertigem	schlüsselfertigem
Gereon	Gereon
Unternehmenspartnerschaften	Unternehmenspartnerschaften
ILB	ILB
Erfurt	Erfurt
Eisbahnbahnanlagen	Eisbahnbahnanlagen
Kosten	Kosten
keine	kein
Desinfektion	Desinfektion
Ludwigsfelde	Ludwigsfelde
Preuss	Preuss
Schall	Schall
Fernsehproduktionen	Fernsehproduktion
Prüfarbeiten	Prüfarbeiten
Ole	Ole
entsprechende	entsprechend
Tamara	Tamara
Offenbach	Offenbach
geändert	ändern
ambulante	ambulant
Raoul	Raoul
Zorn	Zorn
Unterricht	Unterricht
verschiedentlich	verschiedentlich
Sybilla	Sybilla
gleichartiger	gleichartig
stehenden	stehend
in	in
Kleinstreparaturen	Kleinstreparatur
Broschinski	Broschinski
ergänzenden	ergänzend
Anlagenbau	Anlagenbau
Inbetriebnahme	Inbetriebnahme
Sassenberg	Sassenberg
Auslandszweigniederlassungen	Auslandszweigniederlassungen
Jahresabschluß	Jahresabschluß
Beteiligungsgesellschaft	Beteiligungsgesellschaft
HUF	Huf
Alternativkonzepte	Alternativkonzept
Transportsektor	Transportsektor
Muchow	Muchow
Schmiede	Schmiede
g	g
Koblenz	Koblenz
RR	RR
Marketing	Marketing
TRL	TRL
Kuczkowski	Kuczkowski
Otrzasek	Otrzasek
Ruhr	Ruhr
durchzuführen	durchführen
Endkonsumenten	Endkonsument
Schwalbach	Schwalbach
Digitalen	Digitale
II	II
Finow	Finow
Änderungen	Änderung
bedingtes	bedingt
Oppermann	Oppermann
Schweer	Schweer
Kommunikationszentrums	Kommunikationszentrum
Schnittblumen	Schnittblume
ausüben	ausüben
Wald	Wald
Stück	Stück
gleichfalls	gleichfalls
hinaus	hinaus
Treuhandtätigkeiten	Treuhandtätigkeiten
Liquidatorin	Liquidatorin
Antriebskonzepten	Antriebskonzepten
Sven	Sven
Betätigung	Betätigung
Osnabrück	Osnabrück
Wasserhaltungen	Wasserhaltungen
Tragwerksplanungen	Tragwerksplanungen
Dachsteinen	Dachsteinen
Verträgen	Vertrag
konzessionierte	konzessioniert
Implemtierung	Implemtierung
Kommissions	Kommissions
Halbsatz	Halbsatz
Schondorf	Schondorf
Abbruchabfällen	Abbruchabfällen
Schmeling	Schmeling
eingegangen	eingehen
Gesamtvollstreckungen	Gesamtvollstreckungen
einzelnen	einzeln
Folien	Folie
Handelsvertretung	Handelsvertretung
zwei	zwei
Blockhäusern	Blockhaus
Landschaftsbaus	Landschaftsbaus
Schwachstrom	Schwachstrom
Bischler	Bischler
Weiter	weiter
Industrieanlagen	Industrieanlage
Abs.	Abs.
Entrümpelungen	Entrümpelung
Decker	Decker
Zahnärzte	Zahnarzt
weiße	weiß
Aufscihtsrates	Aufscihtsrates
Ge	Ge
Gemmecker	Gemmecker
Illmersdorf	Illmersdorf
gewerbsmäßige	gewerbsmäßig
Brielow	Brielow
Kies	Kies
Schreib	schreiben
Gesellschaftertin	Gesellschaftertin
Einbruchmeldeanlagen	Einbruchmeldeanlagen
Aquise	Aquise
DERTOUR	DERTOUR
Gesteinsbrecher	Gesteinsbrecher
Holböll	Holböll
Ewald	Ewald
Gernert	Gernert
Bertram	Bertram
Bochow	Bochow
Führungskräften	Führungskraft
Ford	Ford
Beförderung	Beförderung
Carina	Carina
Informationstechnologiebranche	Informationstechnologiebranche
Inhalten	Inhalt
Fernsehprojekten	Fernsehprojekt
Berks	Berks
Jenke	Jenke
Karldieter	Karldieter
gleichzeitig	gleichzeitig
Prüfen	Prüfen
Das	d
Gräfrath	Gräfrath
Kujanek	Kujanek
dies	dies
Bäumler	Bäumler
verlegerischen	verlegerisch
Reparaturwerkstatt	Reparaturwerkstatt
Prokuristen	Prokurist
Bading	Bading
genannten	genannt
Fuchs	Fuchs
Belsdorf	Belsdorf
bisherigen	bisherig
betreuung	Betreuung
Behandeln	Behandeln
Hartl	Hartl
Unterböden	Unterböden
Aktiengesellschaft	Aktiengesellschaft
Stücken	Stücken
derjenige	derjenige
Klenner	Klenner
Dietzenbach	Dietzenbach
Reiner	Reiner
Straßenbau	Straßenbau
durch	durch
Beton	Beton
Versicherungen	Versicherung
Küchenmöbeln	Küchenmöbeln
aufgelösten	aufgelöst
Mors	Mors
einem	ein
einzigen	einzig
Paaren	Paaren
Kundendienstleistungen	Kundendienstleistung
Hausfassaden	Hausfassade
Buchin	Buchin
Hochschulabgänger	Hochschulabgänger
Riedel	Riedel
Nutzerfeststellung	Nutzerfeststellung
Dahlenburg	Dahlenburg
Produkte	Produkt
Hausverwaltungsarbeiten	Hausverwaltungsarbeiten
Gewinnabführungsvertrag	Gewinnabführungsvertrag
künstlichen	künstlich
Hochbaumaßnahmen	Hochbaumaßnahme
Cadmus	Cadmus
nochmals	nochmals
Pape	Pape
Belgien	Belgien
Buchwald	Buchwald
BImSchG	BImSchG
eingetragenen	eingetragen
Inlands	Inland
Sieglinde	Sieglinde
Beulshausen	Beulshausen
Bauknecht	Bauknecht
direkt	direkt
Überwindung	Überwindung
Büteröwe	Büteröwe
Volkmar	Volkmar
Desweiteren	Desweiteren
Giepen	Giepen
Gansow	Gansow
medizinischen	medizinisch
Hausmeisterdienstleistungen	Hausmeisterdienstleistungen
Bahn	Bahn
Bottrop	Bottrop
Betonfertigteilen	Betonfertigteilen
Hoer	Hoer
bspw	bspw
Lothar	Lothar
Waren	Ware
Teltow	Teltow
Karolina	Karolina
Gaspar	Gaspar
Reinigungsmitteln	Reinigungsmitteln
Westf	Westf
Schwartau	Schwartau
Munitionsberäumung	Munitionsberäumung
Anstalt	Anstalt
Svetlozara	Svetlozara
Mit	mit
Verbunde	Verbund
E	E
Fredersdorf	Fredersdorf
Spedition	Spedition
Naherholung	Naherholung
Ausführung	Ausführung
Heller	Heller
Verleih	Verleih
Linthe	Linthe
Keskin	Keskin
Seminarräumen	Seminarräumen
Gesamtvertretung	Gesamtvertretung
eingerichtet	einrichten
alleinvertretungsberechtigten	alleinvertretungsberechtigten
Programmentwicklung	Programmentwicklung
Punkten	Punkten
Ostens	Osten
Malerbedarfsartikeln	Malerbedarfsartikeln
Klosterfeld	Klosterfeld
hauptsächlich	hauptsächlich
Geändert	ändern
Frank	Frank
Straßenburg	Straßenburg
Café	Café
Fritsch	Fritsch
Harald	Harald
Verkaufs	Verkauf
Hochbauarbeiten	Hochbauarbeiten
Erfassung	Erfassung
vermarktet	vermarkten
Jugenheim	Jugenheim
Nahmitz	Nahmitz
Hunold	Hunold
Unterhalten	Unterhalten
Altautos	Altauto
KFZ	KFZ
Chastanet	Chastanet
Beratende	beratend
Frischdienst	Frischdienst
zusammen	zusammen
Niederspannungsanlagen	Niederspannungsanlagen
Robby	Robby
Transporter	Transporter
Aufteilung	Aufteilung
allen	alle
Haushaltsgeräten	Haushaltsgerät
Wettbewerbsverbot	Wettbewerbsverbot
Kerstin	Kerstin
Anlaß	Anlaß
Kallin	Kallin
Elektroinstallation	Elektroinstallation
Wohnraum	Wohnraum
Syke	Syke
Grafschaft	Grafschaft
Linden	Linden
Nutzungsrechte	Nutzungsrechte
Klengen	Klengen
Genres	Genre
formwechselnde	formwechselnde
Beisortimenten	Beisortimenten
Stählen	Stählen
GA	GA
Sandhage	Sandhage
Gaia	Gaia
Einrichtungsbereiches	Einrichtungsbereiches
Sanitärgewerbes	Sanitärgewerbes
Heckenroses	Heckenroses
Lichtreklamen	Lichtreklame
Outsourcing	Outsourcing
Auslegung	Auslegung
Otto	Otto
Renndiensten	Renndiensten
Generalbauunternehmer	Generalbauunternehmer
besorgt	besorgt
Natur	Natur
Pritzlaff	Pritzlaff
Schick	Schick
dienenden	dienend
Balance	Balance
Betracht	Betracht
J.	J.
Pizzerien	Pizzeria
Wohngebiete	Wohngebiet
Streifenfundamente	Streifenfundament
Industriebauten	Industriebau
Petzold	Petzold
Schmitten	Schmitten
Campus	Campus
Allgemeinen	Allgemeine
schüttfähigen	schüttfähigen
Vorstand	Vorstand
T	T
indirekt	indirekt
Geißler	Geißler
Tschechien	Tschechien
Christiane	Christiane
Markt	Markt
Bereiche	Bereich
Erforschung	Erforschung
Coswig	Coswig
Scheewe	Scheewe
Veranstaltungs	Veranstaltungs
Hohl	Hohl
Studios	Studio
MVB	MVB
Subunternehmer	Subunternehmer
Gernot	Gernot
Beratern	Berater
Implantaten	Implantat
Retzow	Retzow
Ingeborg	Ingeborg
Gewerbes	Gewerbe
Produktions	Produktions
Güter	Gut
Dienemann	Dienemann
Stechow	Stechow
Agenturgemeinschaft	Agenturgemeinschaft
Molekular	Molekular
Vermietungszwecken	Vermietungszwecken
Rückgewinnung	Rückgewinnung
Pohl	Pohl
Licht	Licht
Hausvertrieb	Hausvertrieb
Bewachung	Bewachung
PVC	PVC
Personalvermittlung	Personalvermittlung
Zellkulturen	Zellkultur
Wohnmöbel	Wohnmöbel
zugelassen	zulassen
Dacheindeckungsarbeiten	Dacheindeckungsarbeiten
Bauwesen	Bauwesen
Discs	Discs
Netzen	Netz
Starkstrom	Starkstrom
Aufgabe	Aufgabe
richtet	richten
Aktiva	Aktivum
Verbrauchs	Verbrauch
gleich	gleich
Kalkulationen	Kalkulation
Unterhaltungselektronik	Unterhaltungselektronik
Bilek	Bilek
textilen	textil
Unternehmen	Unternehmen
Filmproduktionen	Filmproduktion
banküblichen	banküblich
Adipositasbehandlung	Adipositasbehandlung
Erwerb	Erwerb
Paragrafen	Paragraf
privaten	privat
Landschafts	Landschafts
genehmigte	genehmigt
eigene	eigen
t	t
Erdbauarbeiten	Erdbauarbeiten
Steinsetzarbeiten	Steinsetzarbeiten
führt	führen
Lehmann	Lehmann
Elektroinstallationen	Elektroinstallation
Oststeinbek	Oststeinbek
Coir	Coir
BBodSchG	BBodSchG
Ruppiner	Ruppiner
Betonanlage	Betonanlage
Automatisierungsanlagen	Automatisierungsanlage
Rangsdorf	Rangsdorf
Dieses	dies
Gebäudeausrüstung	Gebäudeausrüstung
Housekeeping	Housekeeping
Jürgen	Jürgen
Dacharbeiten	Dacharbeiten
entfalten	entfalten
Düben	Düben
erstrecken	erstrecken
Kernchen	Kernchen
Schrader	Schrader
Maschinenbauerzeugnissen	Maschinenbauerzeugnissen
Pächtern	Pächter
Henke	Henke
abzuschließen	abschließen
Sanierungsarbeiten	Sanierungsarbeiten
Jahresabschluss	Jahresabschluss
Knepper	Knepper
Fußbodenbelägen	Fußbodenbelag
Brigitte	Brigitte
Jehne	Jehne
Einzelprokuristen	Einzelprokuristen
Komplettlösungen	Komplettlösung
Henry	Henry
insbesondere	insbesondere
Fachhochschule	Fachhochschule
Stueber	Stueber
gleichgearteten	gleichgeartet
Komplementärstellung	Komplementärstellung
Ketzin	Ketzin
Jacek	Jacek
Dalichow	Dalichow
Roland	Roland
Fechner	Fechner
Ingenieurbau	Ingenieurbau
verwandten	verwandt
Duisburg	Duisburg
Bausanierung	Bausanierung
Treuhand	Treuhand
Rose	Rose
Reichelt	Reichelt
Schreiber	Schreiber
Bekleidungszubehör	Bekleidungszubehör
Herstellungen	Herstellungen
innerhalb	innerhalb
Anzeiger	Anzeiger
Ludwigshafen	Ludwigshafen
Irmtraud	Irmtraud
medienpolitischen	medienpolitisch
genehmigungspflichtigen	genehmigungspflichtig
Ausstellungen	Ausstellung
R.	R.
Nelly	Nelly
Kleintransporte	Kleintransport
Genshagen	Genshagen
Beratungstätigkeiten	Beratungstätigkeit
worden	werden
Artur	Artur
Kinospielfilme	Kinospielfilm
Rausch	Rausch
Fargo	Fargo
Freydank	Freydank
projektgebundenen	projektgebunden
Gerald	Gerald
Kyritz	Kyritz
Leitung	Leitung
Hotels	Hotel
Schuhmacher	Schuhmacher
Hausverwaltungen	Hausverwaltung
Vorhandensein	Vorhandensein
Wirtschaft	Wirtschaft
Gebäudedienstleistungen	Gebäudedienstleistungen
Grundreinigung	Grundreinigung
Die	d
Umstellung	Umstellung
Betriebswirtschaftliche	betriebswirtschaftlich
Kälte	Kälte
Dachdeckerarbeiten	Dachdeckerarbeiten
Institut	Institut
Holz	Holz
Baubetreuungen	Baubetreuungen
Elektroinstallationsarbeiten	Elektroinstallationsarbeiten
Bauelementehandel	Bauelementehandel
beinhaltet	beinhalten
Tostedt	Tostedt
Mayr	Mayr
Gebrauchsartikeln	Gebrauchsartikel
befreien	befreien
Reichert	Reichert
unverändert	unverändert
Mirjana	Mirjana
Einziehung	Einziehung
erfolgten	erfolgt
teilstationärer	teilstationär
betrieben	betreiben
enthaltenen	enthalten
Leistungen	Leistung
Investmenanteilen	Investmenanteilen
v.d.H.	v.d.H.
Sanitärbau	Sanitärbau
bezweckt	bezwecken
Steinhagen	Steinhagen
diesbezüglichen	diesbezüglich
Florida	Florida
Karosserie	Karosserie
Dachdecker	Dachdecker
Praxisobjekten	Praxisobjekten
Komplementär	komplementär
entsprechend	entsprechend
Kraftfahrzeugzubehör	Kraftfahrzeugzubehör
Raum	Raum
GmbH_&_Co._KG	GmbH_&_Co._KG
Groupware	Groupware
flankierenden	flankierend
Wegfall	Wegfall
Realisation	Realisation
LUK	LUK
Stimmrecht	Stimmrecht
Penz	Penz
auch	auch
Gschwend	Gschwend
Stahlbetonarbeiten	Stahlbetonarbeiten
informationstechnischen	informationstechnisch
Eschbach	Eschbach
Deponieware	Deponieware
Thiele	Thiele
den	d
Alexandra	Alexandra
verbale	verbal
Streu	Streu
Betriebsstoffe	Betriebsstoff
Havel	Havel
Neumünster	Neumünster
betriebliche	betrieblich
denkmalgeschützten	denkmalgeschützt
Bereitstellung	Bereitstellung
Verwaltungstätigkeit	Verwaltungstätigkeit
Schülerfahrten	Schülerfahrt
Weiterveräußerung	Weiterveräußerung
Naarden	Naarden
Schneebeseitigung	Schneebeseitigung
Schutzrechten	Schutzrechten
einbezogen	einbeziehen
unternehmerischen	unternehmerisch
Großbeeren	Großbeere
Natursteine	Naturstein
Bußgeldsachen	Bußgeldsache
Hesse	Hesse
Jacob	Jacob
z.B.	z.B.
Auflösungsbeschluss	Auflösungsbeschluss
Nicolai	Nicolai
Veredlungswirtschaft	Veredlungswirtschaft
Lusch	Lusch
Agenturen	Agentur
Hochbau	Hochbau
AG	AG
Huibregt	Huibregt
einzelne	einzeln
therapeutischer	therapeutisch
Bobzin	Bobzin
nachgelagerte	nachgelagert
Einsätze	Einsatz
Landmaschinen	Landmaschine
Umgestalten	umgestalten
Alexander	Alexander
e	E
verschiedensten	verschieden
Wirtschaftsgütern	Wirtschaftsgut
genehmigtes	genehmigt
Tiefbauleistungen	Tiefbauleistungen
Privathaushalte	Privathaushalt
Hoyzer	Hoyzer
Rostock	Rostock
ergonomischen	ergonomischen
Akustik	Akustik
Verpackungszwecke	Verpackungszwecke
Landwirtschaften	Landwirtschaften
Bezeichnung	Bezeichnung
wirtschaftliche	wirtschaftlich
Tankstelle	Tankstelle
Komplementärin	Komplementärin
Dietrich	Dietrich
Gerüstkonstruktionen	Gerüstkonstruktion
anderem	ander
Umzugsservice	Umzugsservice
Weitergabe	Weitergabe
Filmen	Filmen
Anträge	Antrag
Hinsicht	Hinsicht
Industriemontagen	Industriemontagen
vornehmlich	vornehmlich
Untervermietung	Untervermietung
Mox	Mox
Hannelore	Hannelore
Bahnsdorf	Bahnsdorf
Saterland	Saterland
Bauprojekten	Bauprojekt
Siebenunddreißigste	siebenunddreißigst
gastronomisch	gastronomisch
Mier	Mier
genehmigungspflichtig	genehmigungspflichtig
Fassadengestaltung	Fassadengestaltung
Ziech	Ziech
Erbbauzinses	Erbbauzins
Programmen	Programm
Dachzubehör	Dachzubehör
Löwenbruch	Löwenbruch
Privat	privat
Kreislaufwirtschafts	Kreislaufwirtschafts
entsprechendem	entsprechend
Trainervermittlung	Trainervermittlung
Eintragung	Eintragung
Sidding	Sidding
soft	soft
Fertigteilen	Fertigteilen
Prüfung	Prüfung
Wissenschaftszweigen	Wissenschaftszweigen
Hendel	Hendel
Zusammensetzung	Zusammensetzung
Beratungsdienstleistungen	Beratungsdienstleistungen
sogenannten	sogenannt
Oranienburg	Oranienburg
Wiesenburg	Wiesenburg
Kommunikationsdienstleistungen	Kommunikationsdienstleistungen
Leistungsträger	Leistungsträger
Aufnahme	Aufnahme
Marcella	Marcella
Hausmeisterservice	Hausmeisterservice
Grundstücksgesellschaft	Grundstücksgesellschaft
klima	Klima
Remke	Remke
Mayen	Mayen
Buchhaltungs	Buchhaltungs
Hamann	Hamann
Brillenetuis	Brillenetuis
Schatte	Schatte
Fassaden	Fassade
vertretungsberechtigt	vertretungsberechtigt
Kommunikationsprojekten	Kommunikationsprojekten
Produktionsequipment	Produktionsequipment
Friedrichsdorf	Friedrichsdorf
Baufirma	Baufirma
Krankengymnastik	Krankengymnastik
C	C
Vornahme	Vornahme
einwandfreien	einwandfrei
Wertstoffen	Wertstoff
Timo	Timo
Beykoz	Beykoz
Büro	Büro
Bodens	Boden
Christel	Christel
Baudurchführung	Baudurchführung
Alme	Alme
weiteren	weit
Kabelanlagen	Kabelanlage
Abriß	Abriß
Personalmanagementaufgaben	Personalmanagementaufgaben
Lizenzrechte	Lizenzrechte
Trebbin	Trebbin
Fassung	Fassung
treuhänderische	treuhänderische
Grundbesitz	Grundbesitz
nebst	nebst
Stade	Stade
Vorrichtungs	Vorrichtungs
Darin	darin
Wohlfahrtszwecke	Wohlfahrtszwecke
Qualifizierung	Qualifizierung
Geschäftsführern	Geschäftsführer
Schreibwarenhandel	Schreibwarenhandel
erlaubnisfreien	erlaubnisfrei
Siegrid	Siegrid
zu	zu
gründen	gründen
Vorsitzenden	Vorsitzende
Bens	Bens
Nebentätigkeiten	Nebentätigkeit
Erteilung	Erteilung
baurechtlichen	baurechtlich
keiner	kein
Ehring	Ehring
Projektmanagement	Projektmanagement
Belegtransporten	Belegtransporten
Rantzsch	Rantzsch
erster	erst
Nachtrag	Nachtrag
Karp	Karp
Stadt	Stadt
Restauration	Restauration
Vorfertigung	Vorfertigung
Vertragspartner	Vertragspartner
Zuständigkeit	Zuständigkeit
Veränderung	Veränderung
Baum	Baum
Finanzvertriebs	Finanzvertriebs
/geologischen	/geologischen
Schmitz	Schmitz
Grunderwerb	Grunderwerb
Edith	Edith
Industrietransport	Industrietransport
Abdichtung	Abdichtung
planung	Planung
Salow	Salow
Höhenkirchen	Höhenkirche
Tonnen	Tonne
Kostic17.03.1958	Kostic17.03.1958
gleichartigem	gleichartigem
Melanie	Melanie
Klebstoffen	Klebstoff
Bernau	Bernau
Recht	Recht
Brno	Brno
Willem	Willem
Rechtsberatungsgesetz	Rechtsberatungsgesetz
Sandler	Sandler
Weisgerber	Weisgerber
diagnostischer	diagnostisch
bilden	bilden
Investitionsvorhaben	Investitionsvorhaben
Müller	Müller
Lenkeit	Lenkeit
Golm	Golm
Milenkovic	Milenkovic
Hülsmann	Hülsmann
Vermögens	Vermögen
Systemgedanken	Systemgedanken
teilweise	teilweise
Ahmet	Ahmet
Tierzucht	Tierzucht
Thilo	Thilo
Klinker	Klinker
Haller	Haller
Planungs	Planungs
Raabe	Raabe
Hoffbauer	Hoffbauer
stehender	stehend
Gewinnausschüttung	Gewinnausschüttung
Meisel	Meisel
Innenausstattung	Innenausstattung
Gräser	Gras
Bestand	Bestand
Prodctions	Prodctions
kommunalen	kommunal
Zehlendorf	Zehlendorf
Kopierläden	Kopierläden
Parsiegla	Parsiegla
ftsf	ftsf
Dipl.-Volkswirt	Dipl.-Volkswirt
auszuschöpfen	ausschöpfen
Rechtsgeschäften	Rechtsgeschäft
Fortbildungsveranstaltungen	Fortbildungsveranstaltung
Wärmelieferung	Wärmelieferung
Verbände	Verband
eigenen	eigen
FuE	FuE
Vermögensschadensversicherung	Vermögensschadensversicherung
Geschäftsfragen	Geschäftsfragen
Recyclingmaterial	Recyclingmaterial
Aluminiumkonstruktionen	Aluminiumkonstruktion
anderer	ander
Finanzdienstleistunge	Finanzdienstleistunge
Scholl	Scholl
traditionelle	traditionell
beherrschte	beherrscht
Gebäudediensten	Gebäudediensten
Rohstoffen	Rohstoff
anfänglichen	anfänglich
Dipl.Psychologen	Dipl.Psychologen
Datenverarbeitungs	Datenverarbeitungs
Berka	Berka
Bartholomäus	Bartholomäus
Bekleidung	Bekleidung
Products	Products
drehbaren	drehbar
Wille	Wille
Großer	Große
Natursteinmaterialien	Natursteinmaterialien
Oberflächenbehandlungen	Oberflächenbehandlungen
b	B
Stillstandsreparatur	Stillstandsreparatur
Planungsleistungen	Planungsleistung
Wolowicz	Wolowicz
Aquisition	Aquisition
Aufgabengebiete	Aufgabengebiet
Veredelung	Veredelung
Ermach	Ermach
Bauweisen	Bauweisen
Übernahme	Übernahme
ETB	ETB
Balk	Balk
Unna	Unna
Teßmer	Teßmer
Überwachung	Überwachung
BeBeKaR	BeBeKaR
Lünow	Lünow
Grahn	Grahn
Stein	Stein
Zahn	Zahn
Rathenow	Rathenow
historische	historisch
Köse	Köse
Kuhrmann	Kuhrmann
Rechts	Recht
Clemens	Clemens
Schwegler	Schwegler
Urs	Ur
Linde	Linde
Einfriedungen	Einfriedung
Langzeitberatungen	Langzeitberatungen
Versatile	Versatile
Generalübernehmer	Generalübernehmer
verfolgt	verfolgen
Kabelverlegung	Kabelverlegung
Einbeziehung	Einbeziehung
Gewerbetreibende	Gewerbetreibende
Informationsverbreitung	Informationsverbreitung
Töpel	Töpel
Gräfelfing	Gräfelfing
nationalen	national
Viola	Viola
präventive	präventiv
Tätigkeiten	Tätigkeit
Den	d
unverarbeitetem	unverarbeitetem
Spezialleistungen	Spezialleistungen
Stephanie	Stephanie
Entsorgungs	Entsorgungs
Michael	Michael
Datenverarbeitungsprogrammen	Datenverarbeitungsprogrammen
Germann	Germann
Böke	Böke
z.	z.
Rautengarten	Rautengarten
Marc	Marc
Diplomingenieur	Diplomingenieur
Putz	Putz
Anzeigenannahme	Anzeigenannahme
Tiefbaus	Tiefbau
Objekte	Objekt
Kraftwerken	Kraftwerken
Kommandististen	Kommandististen
Wagner	Wagner
Schmidt	Schmidt
Daniel	Daniel
Heimtextilien	Heimtextilie
Ruoff	Ruoff
Senzig	Senzig
Victorowitsch	Victorowitsch
Steuererklärungen	Steuererklärung
Errichtungsverpflichtung	Errichtungsverpflichtung
Dittmann	Dittmann
Fassadenbekleidungen	Fassadenbekleidungen
LG	LG
Vorwald	Vorwald
handwerksähnlich	handwerksähnlich
Kamera	Kamera
Dipl.Ing	Dipl.Ing
Baumaterial	Baumaterial
Carola	Carola
PM	PM
Hauptversammlung	Hauptversammlung
nötigen	nötig
Klamrowsky	Klamrowsky
Gestaltung	Gestaltung
Verpachtung	Verpachtung
Brandt	Brandt
Boris	Boris
Geschäftsführungs	Geschäftsführungs
Marr	Marr
Niedercunnersdorf	Niedercunnersdorf
Lagergeschäften	Lagergeschäften
berufen	berufen
Most	Most
sofern	sofern
Einberufung	Einberufung
Herbert	Herbert
Pommert	Pommert
dass	dass
RGW	RGW
Fliesenlegers	Fliesenleger
Ressel	Ressel
vom	vom
Hammel	Hammel
Installationsböden	Installationsböden
nunmehr	nunmehr
Banknoten	Banknote
vorstehenden	vorstehend
Aufsichrtsrates	Aufsichrtsrates
Vorsitzende	Vorsitzende
Stahlbetonbau	Stahlbetonbau
Hanke	Hanke
d.	d.
Zichem	Zichem
Anleger	Anleger
Bögle	Bögle
Helmut	Helmut
Wanderwege	Wanderweg
Förderprogrammen	Förderprogramm
Kerl	Kerl
neuer	neu
Deckung	Deckung
Beratungstätigkeit	Beratungstätigkeit
material	material
Rekonstruktion	Rekonstruktion
König	König
Ist	sein
Einheit	Einheit
Technologien	Technologie
Beschluss	Beschluss
Demmler	Demmler
VW	VW
Döberitz	Döberitz
Eigenbetriebes	Eigenbetrieb
Fertigprodukten	Fertigprodukt
Axel	Axel
Versiegelung	Versiegelung
langfristige	langfristig
vertreibt	vertreiben
komplexe	komplex
eingeteilt	einteilen
Aufbereitung	Aufbereitung
um	um
Rom	Rom
Gewerbeimmobilien	Gewerbeimmobilie
präventiver	präventiv
Markus	Markus
Kommunikations	Kommunikations
Abfallwirtschaft	Abfallwirtschaft
Geschäfte	Geschäft
Leverkusen	Leverkusen
Stahlbetonbauerhandwerk	Stahlbetonbauerhandwerk
Stephan	Stephan
beschränkter	beschränkt
Media	Media
humanen	human
national	national
Maschinenteilen	Maschinenteilen
Abbau	Abbau
Klink	Klink
individuelle	individuell
i.S.v.	i.S.v.
übernommen	übernehmen
internationale	international
Schülerspeisung	Schülerspeisung
Halbe	Halbe
Konsolidierungs	Konsolidierungs
Asphaltierarbeiten	Asphaltierarbeiten
Sportarten	Sportarten
Förderung	Förderung
Ilse	Ilse
Tenschert	Tenschert
Faserplatten	Faserplatten
Mitteldeutschen	Mitteldeutsche
Steckelsdorf	Steckelsdorf
Strategien	Strategie
Juwelier	Juwelier
Ottenbach	Ottenbach
Uta	Uta
Projekt	Projekt
Rolladen	Rolladen
Jugendhilfe	Jugendhilfe
räumlichen	räumlich
Regalen	Regal
WSE	WSE
Solarien	Solarie
Schalungs	Schalungs
Hotelreinigung	Hotelreinigung
Schaap	Schaap
Antje	Antje
Einhaltung	Einhaltung
Bindow	Bindow
öffentliche	öffentlich
Automatisierung	Automatisierung
Bauschuttverwertung	Bauschuttverwertung
analysiert	analysieren
Hestellung	Hestellung
Pflanzenöl	Pflanzenöl
Käsewaren	Käseware
Single	Single
wohnwirtschaftlichen	wohnwirtschaftlichen
Süß	süß
darunter	darunter
Moritz	Moritz
Rohrleitungen	Rohrleitung
Grießer	Grießer
Treuenbrietzen	Treuenbrietzen
Oberflächentechnik	Oberflächentechnik
Zeiteinheiten	Zeiteinheit
Betonarbeiten	Betonarbeiten
B.O.S.S.	B.O.S.S.
Starke	Starke
Je	je
Dachklempner	Dachklempner
Objektüberwachung	Objektüberwachung
Kundendienstservice	Kundendienstservice
Befriedigung	Befriedigung
Ove	Ove
Raumausstatterhandwerk	Raumausstatterhandwerk
verlagenen	verlagenen
computergestützten	computergestützt
Bauherrenservice	Bauherrenservice
Wessel	Wessel
Wohnungsunternehmen	Wohnungsunternehmen
Prochnow	Prochnow
als	als
Holzbaus	Holzbaus
Birkner	Birkner
Speditionsgut	Speditionsgut
notwendig	notwendig
Mosaikverlegearbeiten	Mosaikverlegearbeiten
Internet	Internet
Zenker	Zenker
Grundlage	Grundlage
gemeinschaftlich	gemeinschaftlich
Wiesenbad	Wiesenbad
Bargteheide	Bargteheide
gelegen	liegen
Sybille	Sybille
Humbert	Humbert
Telekom	Telekom
am	am
Leistungsvermittlung	Leistungsvermittlung
Gerhard	Gerhard
PS	PS
Mediendienstleistungen	Mediendienstleistungen
Zieboll	Zieboll
Verwaltungs	Verwaltungs
Artikeln	Artikel
Heinze	Heinze
Weidenberg	Weidenberg
Einhundertsiebenundfünfzigste	Einhundertsiebenundfünfzigste
Nägler	Nägler
Sanitärmaterial	Sanitärmaterial
Schwimmbecken	Schwimmbecken
Kapital	Kapital
Zielstellung	Zielstellung
Konzipierung	Konzipierung
Industrie	Industrie
Objektverwaltungsgesellschaften	Objektverwaltungsgesellschaften
Festsetzung	Festsetzung
sei	sein
Grundbesitzes	Grundbesitz
derartiger	derartig
Kiesche	Kiesche
Scharnow	Scharnow
Messen	Messen
Bodenverlegearbeiten	Bodenverlegearbeiten
gleicher	gleich
Filialbetriebe	Filialbetrieb
Immobilienverwaltungsgesellschaft	Immobilienverwaltungsgesellschaft
Anpassung	Anpassung
May	May
Wohngebäuden	Wohngebäude
Geschäftszwecks	Geschäftszwecks
Hamberge	Hamberge
Flughafen	Flughafen
Personal	Personal
Topfpflanzen	Topfpflanzen
Beese	Beese
Malchow	Malchow
Anto	Anto
Gewinnverwertung	Gewinnverwertung
Nikola	Nikola
Verschmelzung	Verschmelzung
Caminchen	Caminchen
ITB	ITB
Bauen	Bauen
von	von
notwendiger	notwendig
Häusler	Häusler
M.	M.
Unternehmer	Unternehmer
Multi	Multi
Ansonsten	ansonsten
Bochum	Bochum
Ofer	Ofer
Publikationen	Publikation
rehabilitative	rehabilitative
Gläubigern	Gläubiger
Professor	Professor
Abbruchs	Abbruch
Hulke	Hulke
Decken	Decken
Gossett	Gossett
verkauf.	verkauf.
Nürnberg	Nürnberg
B.O.T.	B.O.T.
Niederlehme	Niederlehm
Leipe	Leipe
psychologischen	psychologisch
berufsbegleitender	berufsbegleitend
Kraftstoffen	Kraftstoff
Grimm	Grimm
Pittrich	Pittrich
erfordert	erfordern
food	food
Profis	Profi
Sonderkulturen	Sonderkultur
Wärmedienst	Wärmedienst
Giselher	Giselher
Bachera	Bachera
Lebensmittelzutaten	Lebensmittelzutaten
Heizungsinstallationsarbeiten	Heizungsinstallationsarbeiten
Agentengeschäften	Agentengeschäften
David	David
Maschewski	Maschewski
Sporttherapie	Sporttherapie
Sportartikelindustrie	Sportartikelindustrie
kann	können
Nordh	Nordh
Auflösung	Auflösung
Verwaltungsorganisation	Verwaltungsorganisation
Arbeitnehmern	Arbeitnehmer
Mineralstoffen	Mineralstoff
Nutzungsrechten	Nutzungsrechten
Metallkonstruktionen	Metallkonstruktion
artverwandte	artverwandt
dazugehörenden	dazugehörend
Scheit	Scheit
regionaler	regional
Schlegel	Schlegel
Boden	Boden
Bauobjekten	Bauobjekt
Stenz	Stenz
Steindl	Steindl
Klasen	Klasen
Eierschale	Eierschale
Delikaya	Delikaya
Meub	Meub
unternehmensberatende	unternehmensberatende
satellitengestützten	satellitengestützt
Workern	Workern
Pfreimd	Pfreimd
Königstadt	Königstadt
Fabrikanlagen	Fabrikanlage
Cinelove	Cinelove
Zustimmung	Zustimmung
medizinischer	medizinisch
Barthold	barthold
Forderungen	Forderung
Ingmar	Ingmar
Dill	Dill
Bauplanungs	Bauplanungs
Papke	Papke
ganzheitliche	ganzheitlich
oberirdischen	oberirdisch
Lackiererei	Lackiererei
Spanien	Spanien
Grischkat	Grischkat
Managementdienstleistungen	Managementdienstleistungen
es	es
team	Team
gärtnerischen	gärtnerischen
Fenster	Fenster
Problemlösungen	Problemlösung
stes	stes
Stiawa	Stiawa
Weidt	Weidt
Edgar	Edgar
Heidelberg	Heidelberg
Eckhardt	Eckhardt
Land	Land
Gesellschaftskapital	Gesellschaftskapital
Markee	Markee
Güterfernverkehr	Güterfernverkehr
Holzbauarbeiten	Holzbauarbeiten
Meckenheim	Meckenheim
Möllmann	Möllmann
vormals	vormals
Ottersberg	Ottersberg
Steuerbilanzen	Steuerbilanzen
Reisebüro	Reisebüro
Pflegebedüftigen	Pflegebedüftigen
Immobilienvertrieb	Immobilienvertrieb
Döring	Döring
Peter	Peter
Regelanlagen	Regelanlage
Verpackungshilfsmitteln	Verpackungshilfsmitteln
Grundstücksgeschäften	Grundstücksgeschäft
fremdem	fremd
Götz	Götz
technischen	technisch
Lenz	Lenz
Lösungen	Lösung
Baatz	Baatz
Booten	Booten
Teschner	Teschner
Baubetreuung	Baubetreuung
Handelstätigkeit	Handelstätigkeit
Ausrüstungshandels	Ausrüstungshandels
Altmann	Altmann
erforderlichen	erforderlich
Verfahrenstechniken	Verfahrenstechnik
Systems	System
Jugendlichen	Jugendliche
Zwanzigste	zwanzigst
de	de
Bartsch	Bartsch
Gerstmann	Gerstmann
Melioration	Melioration
Schulabschlüsse	Schulabschluß
landwirtschaflichen	landwirtschaflichen
Systemen	System
erlaubnispflichtig	erlaubnispflichtig
Kaufmannsgütern	Kaufmannsgut
Rosseburg	Rosseburg
Fernsehproduktionsgesellschaften	Fernsehproduktionsgesellschaften
Jansen	Jansen
Anhalt	Anhalt
Walter	Walter
Grundstücksentwicklungs	Grundstücksentwicklungs
Bekanntmachungen	Bekanntmachung
seit	seit
Natursteinbelägen	Natursteinbelägen
TRI	TRI
Koloquien	Koloquien
Bauausführungen	Bauausführung
Medical	Medical
Faust	Faust
zählt	zählen
Wachtendonk	Wachtendonk
Nunsdorf	Nunsdorf
Rita	Rita
Bewirtschaftung	Bewirtschaftung
Barth	Barth
Reinigungsarbeiten	Reinigungsarbeiten
Vertrieb	Vertrieb
Anwendungssysteme	Anwendungssysteme
organisatorische	organisatorisch
Abbruchmaschinen	Abbruchmaschinen
Gross	Gross
Warten	Warten
MJ	MJ
a.d.H	a.d.H
Vertriebsorganisation	Vertriebsorganisation
Grundstückes	Grundstück
Entwicklungsleistungen	Entwicklungsleistung
Horst	Horst
Gericht	Gericht
Garavy	Garavy
Scheffler	Scheffler
Heidrun	Heidrun
Pohnke	Pohnke
kunststoffbeschichteten	kunststoffbeschichtet
Hemberger	Hemberger
Düsseldorf	Düsseldorf
zuletzt	zuletzt
Nürenberg	Nürenberg
Transportlogistik	Transportlogistik
Pfeiffer	Pfeiffer
Energie	Energie
Müll	Müll
naturbelassenem	naturbelassen
Reinigungsprodukten	Reinigungsprodukten
Boese	Boese
Schäfer	Schäfer
Samini	Samini
Dahlwitz	Dahlwitz
Sporttauchern	Sporttaucher
Mathias	Mathias
Bistros	Bistro
LenLinas	LenLinas
Anlagen	Anlage
aufgehobenen	aufgehoben
H.	H.
Promotionsbereich	Promotionsbereich
Behältern	Behälter
Anzeigenagentur	Anzeigenagentur
Kindergartens	Kindergärten
Konsumwaren	Konsumware
desjenigen	desjenigen
Burghardt	Burghardt
Managementseminaren	Managementseminaren
Serienkonfektion	Serienkonfektion
Krankenschwester	Krankenschwester
Vorstandsmitglied	Vorstandsmitglied
plötzlichem	plötzlich
Mercedes	Mercedes
Auswertung	Auswertung
Recyclingmaßnahmen	Recyclingmaßnahmen
Cornelia	Cornelia
W.	W.
Biessel	Biessel
Steil	steil
Renkwitz	Renkwitz
Edmund	Edmund
übereinstimmt	übereinstimmen
Schrapel	Schrapel
dadurch	dadurch
Raumtextilien	Raumtextilien
Konzeption	Konzeption
Mischke	Mischke
Projektkoordination	Projektkoordination
Kfz	Kfz
Bau	Bau
Neumann	Neumann
Jon	Jon
Haci	Haci
Zossen	Zossen
Spezialisten	Spezialist
Bauherr	Bauherr
Tiedens	Tiedens
schaffen	schaffen
Zeising	Zeising
Tekyaygil	Tekyaygil
Baufinanzierungen	Baufinanzierung
Audi	Audi
Erweitern	Erweitern
medizinischtechnischen	medizinischtechnischen
Janusz	Janusz
Gombert	Gombert
Grundkapitals	Grundkapital
Mutscher	Mutscher
Künzel	Künzel
Fernsehproduktion	Fernsehproduktion
Forschungsmethoden	Forschungsmethode
Abbinden	Abbinden
Lichttechnik	Lichttechnik
übernehmen	übernehmen
Fragestellungen	Fragestellung
Schallplatten	Schallplatten
Reiseleistungen	Reiseleistungen
Dazu	dazu
Zeitungen	Zeitung
Deutelmoser	Deutelmoser
Groß	Groß
Internates	Internat
Glindow	Glindow
Spranger	Spranger
Frommberg	Frommberg
jeglichen	jeglich
Schweinitz	Schweinitz
Omnibusreisen	Omnibusreisen
Gelegenheiten	Gelegenheit
Pitz	Pitz
Sanitärhandwerks	Sanitärhandwerks
Teppichboden	Teppichböden
Rasen	Rasen
Erarbeitung	Erarbeitung
Lederverarbeitung	Lederverarbeitung
Schiplak	Schiplak
G.L.	G.L.
Rogler	Rogler
Trennwänden	Trennwand
Zeitung	Zeitung
Managementaufgaben	Managementaufgabe
Trockenbauhandwerks	Trockenbauhandwerks
Rechnung	Rechnung
eine	ein
Betonbau	Betonbau
Softwareproduktentwicklung	Softwareproduktentwicklung
Sanitärtechnik	Sanitärtechnik
Metallbe	Metallbe
Immobilienobjekten	Immobilienobjekten
verschiedenen	verschieden
Medienwerken	Medienwerken
gesamten	gesamt
Schenkenberg	Schenkenberg
Lamellenvorhängen	Lamellenvorhängen
Archivierung	Archivierung
Lehre	Lehre
Verkaufsveranstaltungen	Verkaufsveranstaltung
Bildträgern	Bildträger
prophylaktischen	prophylaktisch
Antennenanlagen	Antennenanlage
laufender	laufend
Sturm	Sturm
ebenso	ebenso
Fess	Fess
Aktivitäten	Aktivität
Arbeitnehmerüberlassungsgesetz	Arbeitnehmerüberlassungsgesetz
Reiterhofes	Reiterhof
Schott	Schott
Geschäftsgebäuden	Geschäftsgebäude
Ameropa	Ameropa
Töplitz	Töplitz
persönlich	persönlich
Gummierzeugnisse	Gummierzeugnisse
Gesellschaftsgründung	Gesellschaftsgründung
Hein	Hein
einer	ein
Horneburg	Horneburg
Koch	Koch
Naturstein	Naturstein
Gerhardt	Gerhardt
Vertreterin	Vertreterin
Eigentümergemeinschaften	Eigentümergemeinschaft
Pachtung	Pachtung
Völklingen	Völklingen
Fertigteilhäusern	Fertigteilhäusern
für	für
Glien	Glien
Ekkehard	Ekkehard
Schonert	Schonert
förderliche	förderlich
Bauhaupt	Bauhaupt
Kommunikationskonzepten	Kommunikationskonzepten
Rindfleisch	Rindfleisch
Movies	Movies
Melzer	Melzer
Computerhard	Computerhard
Kunstbühne	Kunstbühne
Zustand	Zustand
Mitarbeitern	Mitarbeiter
Vermögensanlagen	Vermögensanlage
Mediaplanung	Mediaplanung
Kommunal	kommunal
Böhm	Böhm
betonartigen	betonartigen
hierfür	hierfür
Erden	Erden
Dipl.-Ingenieur	Dipl.-Ingenieur
Fernsehstudios	Fernsehstudio
Abschlüsse	Abschluß
Akquisation	Akquisation
laufende	laufend
Firmengruppe	Firmengruppe
unterschiedlicher	unterschiedlich
Mihaylova	Mihaylova
Schwarmstedt	Schwarmstedt
Basner	Basner
Kommanditgesellschafter	Kommanditgesellschafter
Behrend	Behrend
Garagenzufahrten	Garagenzufahrten
Massagen	Massage
Annette	Annette
Kleinmechanismen	Kleinmechanismen
Botengänge	Botengang
Vermittlung	Vermittlung
Reschke	Reschke
Informations	Informations
Eingliederungshilfe	Eingliederungshilfe
Klussmann	Klussmann
Belägen	Belag
gegebenenfalls	gegebenenfalls
Räumen	Räumen
Nutzlast	Nutzlast
grundsätzlich	grundsätzlich
Rentenversicherung	Rentenversicherung
zuträglichen	zuträglich
Technischen	technisch
Campingplätzen	Campingplatz
Brose	Brose
gesellschaftsfremden	gesellschaftsfremden
Hard	Hard
Schlotzhauer	Schlotzhauer
RC	RC
touristischen	touristisch
dazugehörigen	dazugehörig
Karpzow	Karpzow
Stahlbetonbauarbeiten	Stahlbetonbauarbeiten
geführt	führen
Güterfelde	Güterfeld
Güterversendung	Güterversendung
Davut	Davut
Fleischhandelsgesellschaft	Fleischhandelsgesellschaft
Druck	Druck
Bessau	Bessau
Lebensmittelbereich	Lebensmittelbereich
Gabor	Gabor
fünfunddreißigste	fünfunddreißigst
Entgeld	Entgeld
Unterhaltung	Unterhaltung
Blähtonwandelelementen	Blähtonwandelelementen
Neuverlegung	Neuverlegung
Erzeugung	Erzeugung
Notstromaggregaten	Notstromaggregat
Rechtsträger	Rechtsträger
sonst	sonst
Kurierdienste	Kurierdienst
regionale	regional
eingesehen	einsehen
Pfeil	Pfeil
Bauservice	Bauservice
Internetpräsenzen	Internetpräsenzen
stationärer	stationär
Kreutz	Kreutz
über	über
solchen	solch
Warenzeichen	Warenzeichen
Schrotte	Schrotte
Datenbanken	Datenbank
unbebauten	unbebaut
Djuren	Djuren
Ariane	Ariane
primär	primär
Zimmereiarbeiten	Zimmereiarbeiten
Küchen	Küche
Paul	Paul
Weinholz	Weinholz
Sanitärleistungen	Sanitärleistungen
Bremen	Bremen
haben	haben
Chesne	Chesne
Kommanditisten	Kommanditist
Poganiatz	Poganiatz
Gierschner	Gierschner
Bauer	Bauer
Kanz	Kanz
Gasanlagen	Gasanlage
Geschäftsführungsleistungen	Geschäftsführungsleistungen
Klärschlammtransporten	Klärschlammtransporten
Installation	Installation
Park	Park
Wasserliegeplätzen	Wasserliegeplätzen
stets	stets
entsprechender	entsprechend
Telefonmehrwertangebot	Telefonmehrwertangebot
Brey	Brey
Baden	Baden
Union	Union
Gleis	Gleis
Einzelhandelsfirma	Einzelhandelsfirma
Business	Business
Promotion	Promotion
Volland	Volland
Verwaltungsservice	Verwaltungsservice
Gebert	Gebert
Young	Young
Göttin	Göttin
insgesamt	insgesamt
Firmenzweckes	Firmenzweckes
APG	APG
Elektroinstallationsfirma	Elektroinstallationsfirma
Krebs	Krebs
Baggerarbeiten	Baggerarbeiten
Yildirim	Yildirim
Handelsgeschäften	Handelsgeschäft
Werbeartikel	Werbeartikel
O	O
Bauingenieur	Bauingenieur
Rene	Ren
Organisations	Organisations
III	III
Altbausanierung	Altbausanierung
alleinige	alleinig
Gesellschafters	Gesellschafter
Putzhexe	Putzhexe
Kunststoff	Kunststoff
Märkischen	Märkische
Christina	Christina
Ges.	Ges.
Fernwärmeübergabestationen	Fernwärmeübergabestationen
Wohnhäusern	Wohnhaus
South	South
Umwandlungsgesetzes	Umwandlungsgesetzes
BEG	BEG
vermarktung	Vermarktung
Gefäße	Gefäß
berechtigt	berechtigt
Kummerow	Kummerow
Doppelhäusern	Doppelhaus
Überlassung	Überlassung
Verbrauchserfassungsgeräten	Verbrauchserfassungsgeräten
nahe	nahe
Stellvertreter	Stellvertreter
info	Info
Wasserhebeanlagen	Wasserhebeanlagen
steuerbegünstigter	steuerbegünstigt
kummunale	kummunale
Elternteile	Elternteil
kurzfristige	kurzfristig
Märkische	Märkische
Vertreter	Vertreter
Damen	Dame
deutschen	deutsch
Konzepten	Konzept
Büroeinrichtung	Büroeinrichtung
Radschai	Radschai
Kallmeyer	Kallmeyer
Bistro	Bistro
Schöttle	Schöttle
Kopperschmidt	Kopperschmidt
Rinderzuchtbetriebes	Rinderzuchtbetriebes
Schank	Schank
industriellen	industriell
Toppenstedt	Toppenstedt
Dränagen	Dränage
Altlandsberg	Altlandsberg
Michalek	Michalek
Sparverträgen	Sparverträgen
Handels	Handel
Autowaschanlage	Autowaschanlage
Hartmann	Hartmann
Reittouristik	Reittouristik
Hoffrén	Hoffrén
Recyclinganlagen	Recyclinganlage
Lilienthal	Lilienthal
auf	auf
Nitzsche	Nitzsche
Teilnehmeranschlußleitungen	Teilnehmeranschlußleitungen
Jett	Jett
verwiesen	verweisen
Saparautzki	Saparautzki
Ertel	Ertel
Florian	Florian
Lagerhaltung	Lagerhaltung
spezielle	speziell
Verfügung	Verfügung
Industrielle	industriell
Luther	Luther
Maßnahmen	Maßnahme
Vorrichtungen	Vorrichtung
Geltungsbereich	Geltungsbereich
Elektrowaren	Elektrowaren
technologischem	technologisch
Polzer	Polzer
verlagen	Verlag
Kühne	Kühne
Sicherheitsprodukte	Sicherheitsprodukte
vorstehend	vorstehend
Schrottverwertung	Schrottverwertung
Diethelm	Diethelm
Hertefeld	Hertefeld
Tremmen	Tremmen
Ratei	Ratei
Beherbergungsbetrieben	Beherbergungsbetrieb
Fachthemen	Fachthema
Volker	Volker
Pflegeheimen	Pflegeheim
Ingomar	Ingomar
Anrechnung	Anrechnung
ausdrücklich	ausdrücklich
handwerklicher	handwerklich
Gastronomiebetriebes	Gastronomiebetrieb
Verbrennungsmotoren	Verbrennungsmotor
Bauwerksabdichtungsarbeiten	Bauwerksabdichtungsarbeiten
ein	ein
das	d
herstellerneutrale	herstellerneutrale
Daimler	Daimler
Lieferverträgen	Liefervertrag
Verschmelzungsverträge	Verschmelzungsverträge
abgeschlossen	abschließen
Fichtenwalde	Fichtenwald
Bruckert	Bruckert
Audio	Audio
Berndt	Berndt
Betonstahlmatten	Betonstahlmatten
Abspaltung	Abspaltung
immoservice	immoservice
Natursteinen	Natursteinen
Grundstücksverwaltung	Grundstücksverwaltung
samt	samt
Behandlung	Behandlung
Bolko	Bolko
Erfahrungen	Erfahrung
Baustellen	Baustellen
Versicherungsverträgen	Versicherungsvertrag
Forschungsergebnissen	Forschungsergebnis
Jankowski	Jankowski
Landesinteresse	Landesinteresse
Krzysztof	Krzysztof
Luckau	Luckau
ihrem	ihr
Fernwärme	Fernwärme
Karus	Karus
Freidorf	Freidorf
Istvan	Istvan
zugleich	zugleich
Putzarbeiten	Putzarbeiten
Gebäudetechnik	Gebäudetechnik
Ausrüstungen	Ausrüstung
Reitsport	Reitsport
Neckarsulm	Neckarsulm
umwelttechnischer	umwelttechnischer
Umfeld	Umfeld
Werbemitteln	Werbemitteln
Anthony	Anthony
vertreten	vertreten
Amsterdam	Amsterdam
Motoren	Motor
Instandsetzungsarbeiten	Instandsetzungsarbeiten
SAT	SAT
Dipl.-Biologe	Dipl.-Biologe
Investitionsgütern	Investitionsgut
Einteilung	Einteilung
Finanzierungen	Finanzierung
Strien	Strien
Anfertigung	Anfertigung
Hanne	Hanne
Kaufmännische	kaufmännisch
Getränkeeinzelhandel	Getränkeeinzelhandel
Rechte	Rechte
junge	jung
Couveinhes	Couveinhes
Bröskamp	Bröskamp
Organisationen	Organisation
Kommunalbauten	Kommunalbauten
Regitz	Regitz
Netzwerke	Netzwerk
Warentransporten	Warentransporten
Neufestsetzung	Neufestsetzung
Garbsen	Garbsen
außer	außer
dazugehörige	dazugehörig
umfassende	umfassend
Brot	Brot
Derdack	Derdack
Heibel	Heibel
Entwicklungs	Entwicklungs
Papieren	Papier
Drittunternehmen	Drittunternehmen
Industrielles	industriell
Stuttgart	Stuttgart
raumbildenden	raumbildend
Nachunternehmerleistungen	Nachunternehmerleistungen
sportlichen	sportlich
Becker	Becker
Siegmar	Siegmar
Poschmann	Poschmann
Rickmann	Rickmann
Heinz	Heinz
Therkelsen	Therkelsen
Vervielfältigung	Vervielfältigung
Rosemarie	Rosemarie
Integration	Integration
Jegutidse	Jegutidse
Eltern	Eltern
Scheeßel	Scheeßel
Hartwig	Hartwig
M723	M723
Heyder	Heyder
Kornelia	Kornelia
Ansbach	Ansbach
Marenbach	Marenbach
Europäischen	europäisch
Brandenburger	Brandenburger
Frédéric	Frédéric
Bad	Bad
Hausmann	Hausmann
vermieten	vermieten
Lekkerland	Lekkerland
Wandflächen	Wandfläche
Zernsdorf	Zernsdorf
studienpädagogischen	studienpädagogischen
Fleischer	Fleischer
Rechtshandlungen	Rechtshandlungen
Dachklempnerarbeiten	Dachklempnerarbeiten
Amstelveen	Amstelveen
solcher	solch
Verdrahtung	Verdrahtung
Fernsehspielfilmen	Fernsehspielfilmen
Zimmerarbeiten	Zimmerarbeiten
Heizungen	Heizung
Dienstleistungen	Dienstleistung
Bolle	Bolle
Kromayer	Kromayer
Rechnungswesens	Rechnungswesen
Aufarbeitung	Aufarbeitung
Steuerstrafsachen	Steuerstrafsache
Jorgen	Jorgen
Jensen	Jensen
Meyer	Meyer
Systeme	System
Flurfördergeräten	Flurfördergeräten
Satzung	Satzung
Yudelson	Yudelson
A.	A.
Fliesenmaterial	Fliesenmaterial
Pelz	Pelz
daraus	daraus
Regelungstechnik	Regelungstechnik
heutigen	heutig
erlaubnispflichtigen	erlaubnispflichtigen
bargeldlose	bargeldlos
Structured	Structured
werbliche	werblich
Bedarfs	Bedarf
gefährdet	gefährden
Bismarck	Bismarck
Spaltung	Spaltung
Baugewerbe	Baugewerbe
Werkzeugfachhandel	Werkzeugfachhandel
Interessen	Interesse
Zepf	Zepf
Grund	Grund
ausgegeben	ausgeben
Bootsmotoren	Bootsmotor
Schulzke	Schulzke
Soft	Soft
Willi	Willi
Verträge	Vertrag
Kindertagesstätten	Kindertagesstätte
Stollens	Stollen
Zuhse	Zuhse
benötigten	benötigt
Implementierung	Implementierung
Verkehrsanlagen	Verkehrsanlage
Befreiung	Befreiung
auszuführen	ausführen
Wohnungseigentum	Wohnungseigentum
Bauherren	Bauherr
Trockenbauweise	Trockenbauweise
Madani	Madani
REWE	REWE
NB	NB
Marcus	Marcus
Handelsunternehmen	Handelsunternehmen
gefördert	fördern
dienlich	dienlich
electronic	electronic
drei	drei
Partyservice	Partyservice
Beratungsleistungen	Beratungsleistung
Murat	Murat
Vermietens	Vermietens
Datenvernichtung	Datenvernichtung
Bauträgertätigkeiten	Bauträgertätigkeiten
Meschede	Meschede
Arno	Arno
Krensel	Krensel
Mössbauer	Mössbauer
Sanierungs	Sanierungs
sicherheitsmäßig	sicherheitsmäßig
anerkannte	anerkannt
Fracht	Fracht
Personalentwicklung	Personalentwicklung
Freidank	Freidank
Multimediabereich	Multimediabereich
Shapira	Shapira
Wiesbaden	Wiesbaden
Standard	Standard
ihres	ihr
anfallender	anfallend
Bretschneider	Bretschneider
Grünanlagenpflege	Grünanlagenpflege
Heinzachim	Heinzachim
Nerlich	Nerlich
Yilmaz	Yilmaz
Dubrower	Dubrower
Miklos	Miklos
Turnierplanung	Turnierplanung
befreit	befreien
da	da
geeignet	eignen
Reparatur	Reparatur
Kroh	Kroh
Dassel	Dassel
ausdehnen	ausdehnen
Fitness	Fitness
Bock	Bock
Waltersdorf	Waltersdorf
Quiekborn	Quiekborn
Wildau	Wildau
KfZ	KfZ
Breitenbrunn	Breitenbrunn
Krause	Krause
Vögelsen	Vögelsen
Baukörpern	Baukörper
Buchführungs	Buchführungs
Holzfertigungsprodukten	Holzfertigungsprodukten
Dokumentarfilmen	Dokumentarfilmen
Lkw	Lkw
Überwachungstechnik	Überwachungstechnik
Baumaschinen	Baumaschine
Gesundheitsschutz	Gesundheitsschutz
Autohauses	Autohaus
Gadsdorf	Gadsdorf
Schwab	Schwab
Verkaufen	Verkaufen
Grundstücksaufbereitung	Grundstücksaufbereitung
Eingeschlossen	eingeschlossen
Gastgewerbe	Gastgewerbe
Nachschüsse	Nachschüsse
elektronischer	elektronisch
Telemarketingleistungen	Telemarketingleistungen
Herstellers	Hersteller
Dietel	Dietel
Zweigniederlassung	Zweigniederlassung
Vogler	Vogler
Vertriebsnetzes	Vertriebsnetz
Biotechnologie	Biotechnologie
Beiler	Beiler
Erweiterung	Erweiterung
RI	RI
Bauwerkerhaltung	Bauwerkerhaltung
Dachdecken	Dachdecken
Africa	Africa
Vorstandsmitglieder	Vorstandsmitglied
Arzneimitteln	Arzneimitteln
textil	textil
elektrotechnischer	elektrotechnisch
Andreas	Andreas
bestehen	bestehen
Güterverwaltung	Güterverwaltung
Fußgängerzonen	Fußgängerzone
Neuen	Neue
neuen	neu
Dittrich	Dittrich
Magdeburg	Magdeburg
Ponschap	Ponschap
Seemann	Seemann
Veikko	Veikko
Jurist	Jurist
Allgemeine	allgemein
Pläne	Plan
Rosengarten	Rosengarten
Eckhard	Eckhard
Marcel	Marcel
Monika	Monika
Sicherheit	Sicherheit
Isolierstoffen	Isolierstoff
Militär	Militär
geschäftsmäßige	geschäftsmäßig
Dennis	Dennis
Techno	Techno
Bekanntmachunge	Bekanntmachunge
Stahlbaumontage	Stahlbaumontage
View	View
Staib	Staib
Uhren	Uhr
Turnierbedingungen	Turnierbedingungen
Gemeinde	Gemeinde
Baunebengewerbe	Baunebengewerbe
halbfertigen	halbfertig
Markgrafpieske	Markgrafpieske
Titze	Titze
Spinola	Spinola
Kapitalerhöhung	Kapitalerhöhung
Philologin	Philologin
biologisch	biologisch
Sauerborn	Sauerborn
Zülow	Zülow
Pilz	Pilz
Wohnräume	Wohnraum
Premnitz	Premnitz
Gesellschaft_mit_beschränkter_Haftung	Gesellschaft_mit_beschränkter_Haftung
hergestellten	hergestellt
nennwertlose	nennwertlose
Seniorenheim	Seniorenheim
Simone	Simone
Computerschulungen	Computerschulungen
Feinwerktechnik	Feinwerktechnik
Saatgut	Saatgut
Spieleragentur	Spieleragentur
Typ	Typ
Heihoff	Heihoff
begonnen	beginnen
Brillen	Brille
Geschäftsführerinnen	Geschäftsführerin
Einrichten	Einrichten
Rietz	Rietz
Eduard	Eduard
hrer	hrer
Bildverarbeitung	Bildverarbeitung
Dummersdorf	Dummersdorf
Duske	Duske
Rugard	Rugard
herabgesetzt	herabsetzen
Dichtungsmaterial	Dichtungsmaterial
Bauleistungsbereich	Bauleistungsbereich
Balkongeländern	Balkongeländern
Rechten	Rechten
Kunststoffteilen	Kunststoffteilen
Volkswirt	Volkswirt
ordnungsgemäßen	ordnungsgemäß
Lipke	Lipke
H.P.	H.P.
Friedland	Friedland
Jordanien	Jordanien
Betriebsberatung	Betriebsberatung
Umzüge	Umzug
Felix	Felix
Pann	Pann
Wohnen	Wohnen
Naturschutz	Naturschutz
Krupsack	Krupsack
ferner	fern
Werkzeug	Werkzeug
Anlegen	Anlegen
Istratov	Istratov
Kühn	Kühn
Restaurierung	Restaurierung
Produktionsaktivitäten	Produktionsaktivität
Geschäftes	Geschäft
Klose	Klose
Ausgleichsbank	Ausgleichsbank
Dritte	Dritte
Mögelin	Mögelin
Umweltschutztechnik	Umweltschutztechnik
Bewachungstätigkeit	Bewachungstätigkeit
Projektbetreuung	Projektbetreuung
Solar	solar
vermessenden	vermessend
Gartenzubehör	Gartenzubehör
Marschner	Marschner
Güternah	Güternah
wobei	wobei
Freizeiteinrichtungen	Freizeiteinrichtung
außerordentlichen	außerordentlich
Brieghel	Brieghel
beträgt	betragen
Diedersdorf	Diedersdorf
Erzieherungsprozeß	Erzieherungsprozeß
Nitschke	Nitschke
leisten	leisten
Kunststofferzeugnissen	Kunststofferzeugnissen
Sommerdienste	Sommerdienste
Locktow	Locktow
BMS	BMS
Göken	Göken
Freitag	Freitag
Register	Register
Brilon	Brilon
Tageseinrichtungen	Tageseinrichtung
Nachrichtentechnik	Nachrichtentechnik
komplette	komplett
sportpsychologischem	sportpsychologischem
Auftragsbeschaffung	Auftragsbeschaffung
Heiligenhaus	Heiligenhaus
erweitert	erweitern
Altersklassen	Altersklasse
üblicherweise	üblicherweise
Tobias	Tobias
Meerveld	Meerveld
Gebrauchtwagen	Gebrauchtwagen
Deutsche	deutsch
usw.	usw.
Neuss	Neuss
zukünftigen	zukünftig
Maintal	Maintal
Ute	Ute
Hösbach	Hösbach
Autotransporte	Autotransporte
Landschaftspflege	Landschaftspflege
Zekeriya	Zekeriya
Zwischen	zwischen
Bürofußböden	Bürofußböden
kommt	kommen
projektleitende	projektleitende
Bauwerksüberwachungsmessungen	Bauwerksüberwachungsmessungen
Thüringen	Thüringen
Vereinigte	Vereinigte
Patrick	Patrick
Pflasterarbeiten	Pflasterarbeiten
Ex	Ex
Kreklau	Kreklau
Küttelwesch	Küttelwesch
direkte	direkt
Wohnzwecke	Wohnzwecke
Altenkirch	Altenkirch
Dienstleistung	Dienstleistung
Großtreben	Großtreben
Meinsdorf	Meinsdorf
Bozidar	Bozidar
management	Management
Leasing	Leasing
Spijkermann	Spijkermann
Karin	Karin
Altlastensanierung	Altlastensanierung
Seminarhaus	Seminarhaus
Beckermann	Beckermann
Beger	Beger
Bonstetten	Bonstetten
Mädel	Mädel
Lo	Lo
Schüler	Schüler
erhöht	erhöhen
Wennigsen	Wennigsen
Fertighäuser	Fertighaus
Lebensmittel	Lebensmittel
FIT	FIT
oder	oder
Katlenburg	Katlenburg
Ash	Ash
Chartered	Chartered
anzupassen	anpassen
Vejle	Vejle
Regie	Regie
Kommunikationstechniken	Kommunikationstechnik
Nebengeschäfte	Nebengeschäft
Diane	Diane
Giethoorn	Giethoorn
Charlet	Charlet
Anpachtung	Anpachtung
Betonwerken	Betonwerken
Beherrschungs	Beherrschungs
Anlagenteilen	Anlagenteilen
etc	etc
Fußbodenverlegung	Fußbodenverlegung
Heckenrose	Heckenrose
Tony	Tony
Vertretungswesen	Vertretungswesen
ingenieurmässige	ingenieurmässige
Innenausbau	Innenausbau
Sint	Sint
komplexen	komplex
Wartungen	Wartung
Laufer	Laufer
Herstellen	Herstellen
Immunologie	Immunologie
TKG	TKG
vertraglichen	vertraglich
Schmelt	Schmelt
Hornung	Hornung
optischen	optisch
Betreibervertrag	Betreibervertrag
Gesellschafterbeschluss	Gesellschafterbeschluss
Kunze	Kunze
i.	in
Pflanzenöltechnologie	Pflanzenöltechnologie
Rehagen	Rehagen
Richard	Richard
CHORUS	CHORUS
Gaus	Gau
Einrichtungsgegenständen	Einrichtungsgegenstand
Gäbler	Gäbler
Zentrum	Zentrum
mit	mit
Behnke	Behnke
Discotheken	Discotheke
Sieprath	Sieprath
Festen	Festen
Büromaterialien	Büromaterial
Reisebedarf	Reisebedarf
Bausanierungsarbeiten	Bausanierungsarbeiten
Rechtsberatung	Rechtsberatung
Maurerhandwerksmeister	Maurerhandwerksmeister
relevanten	relevant
Weiterbildungsgängen	Weiterbildungsgängen
Landes	Land
Bootsbau	Bootsbau
Brück	Brück
Veljko	Veljko
Gesamtprokurist	Gesamtprokurist
Betriebe	Betrieb
Kommanditist	Kommanditist
Todorova	Todorova
Verwertungsgesellschaften	Verwertungsgesellschaft
sind	sein
Berücksichtigung	Berücksichtigung
RASTA	RASTA
Scherf	Scherf
Teppichware	Teppichware
Sorge	Sorge
Einschaltung	Einschaltung
Krieblin	Krieblin
Expansionspotential	Expansionspotential
Kösterke	Kösterke
Fahner	Fahner
Anschaffung	Anschaffung
Fruchtschaumweinen	Fruchtschaumweinen
Edda	Edda
Motorrädern	Motorrad
Kasper	Kasper
Trading	Trading
Eva	Eva
Bahnitz	Bahnitz
Realwert	Realwert
Mauer	Mauer
Baustoffen	Baustoff
Wegebauarbeiten	Wegebauarbeiten
msp	msp
Bauwerken	Bauwerken
Angela	Angela
Sonderabfällen	Sonderabfällen
Paulsen	Paulsen
Stuckelementen	Stuckelementen
Beintner	Beintner
Informationssystemen	Informationssystem
Konsumgütern	Konsumgut
Jahnke	Jahnke
ihrerseits	ihrerseits
Dodendorf	Dodendorf
Delvin	Delvin
Transporte	Transport
Ott	Ott
Klausdorf	Klausdorf
Qualitätsmanagement	Qualitätsmanagement
Durchführung	Durchführung
Heimann	Heimann
Ingenieursbauwerken	Ingenieursbauwerken
Jürg	Jürg
geworden	werden
Fahrten	Fahrt
Baufahrzeug	Baufahrzeug
Christine	Christine
Mineralgemische	Mineralgemische
Loelke	Loelke
Nahrungsergänzungsstoffen	Nahrungsergänzungsstoffen
Vermittlungsgeschäfte	Vermittlungsgeschäft
Bank	Bank
redaktionelle	redaktionell
Ingvar	Ingvar
Ahaus	Ahaus
Johannes	Johannes
Sportpartner	Sportpartner
Bassmann	Bassmann
Tieren	Tier
Ulf	Ulf
Gemische	Gemisch
Wohnungseigentumsgesetz	Wohnungseigentumsgesetz
Marienheide	Marienheide
Baumaschinentransporten	Baumaschinentransporten
Kooperation	Kooperation
/Export	/Export
Gebäudereinigungsunternehmen	Gebäudereinigungsunternehmen
Alleinvertretungsrecht	Alleinvertretungsrecht
Stoffen	Stoff
Räum	räumen
AVECS	AVECS
MSK	MSK
Geschenk	Geschenk
Vierzigste	vierzigst
Hamlin	Hamlin
Taunus	Taunus
Handeln	Handeln
Abwässer	Abwässer
Waldbewirtschaftung	Waldbewirtschaftung
Reinigungsleistungen	Reinigungsleistung
regionalen	regional
Nächst	nächst
Marquardt	Marquardt
Gero	Gero
Alice	Alice
insbesonde	insbesonde
gleichen	gleich
ob	ob
erbringt	erbringen
Spielfilmen	Spielfilmen
Bergholz	Bergholz
Elster	Elster
Bautenschutz	Bautenschutz
Abschluß	Abschluß
Platz	Platz
Thea	Thea
Meß	Meß
Zantis	Zantis
Innerhalb	innerhalb
Oren	Oren
Kehrarbeit	Kehrarbeit
betriebswirtschaftliche	betriebswirtschaftlich
Generalübernahme	Generalübernahme
Geld	Geld
Urheberrechten	Urheberrechten
Przyborowski	Przyborowski
Installateur	Installateur
Gunnar	Gunnar
Architektenleistungen	Architektenleistung
Neuruppin	Neuruppin
Computerprogrammierung	Computerprogrammierung
eingefügt	einfügen
Trockenfrüchte	Trockenfrucht
GBP	GBP
Terrassengärten	Terrassengärten
pol.	pol.
Schönfeld	Schönfeld
interface	Interface
Werks	Werk
Bauwerkstrockenlegung	Bauwerkstrockenlegung
Ackerhans	Ackerhans
World	World
Bezugsrechts	Bezugsrecht
Clubs	Club
mildtätige	mildtätig
Lieferanten	Lieferant
Marktforschung	Marktforschung
geprägten	geprägt
einschließlich	einschließlich
kommerzielle	kommerziell
Namensaktien	Namensaktie
Stempel	Stempel
Konfektionierung	Konfektionierung
Produktionsunternehmen	Produktionsunternehmen
Heizzentrale	Heizzentrale
Albert	Albert
Rechtehandel	Rechtehandel
Baudenkmalpflege	Baudenkmalpflege
Veräusserung	Veräusserung
Etablierung	Etablierung
Mörz	Mörz
Ronald	Ronald
Arkades	Arkades
Kühnlein	Kühnlein
Mühlhausen	Mühlhausen
Vermittlungstätigkeiten	Vermittlungstätigkeit
Bekanntmachung	Bekanntmachung
Drehbuchentwicklung	Drehbuchentwicklung
notwendigen	notwendig
Lohnabbund	Lohnabbund
Ausgestaltung	Ausgestaltung
Kosmetikartikel	Kosmetikartikel
Kanter	Kanter
handwerksmäßig	handwerksmäßig
Ärzte	Arzt
Bautätigkeit	Bautätigkeit
Liesegang	Liesegang
Mangold	Mangold
Detlev	Detlev
Erwerber	Erwerber
Aufgrund	aufgrund
Caputh	Caputh
Standortpräsentationen	Standortpräsentationen
Reinhard	Reinhard
Kurth	Kurth
Schust	Schust
Lehnert	Lehnert
Rittweger	Rittweger
Sachleistungen	Sachleistung
Computern	Computer
Renaturierung	Renaturierung
Sportvereine	Sportverein
BB	BB
Thyrow	Thyrow
Turm	Turm
Neuerstellung	Neuerstellung
Vertriebes	Vertrieb
Dachdeckerei	Dachdeckerei
CNC	CNC
Teupitz	Teupitz
Sanitäranlagen	Sanitäranlage
Fugensanierung	Fugensanierung
gültigen	gültig
Autoverwertung	Autoverwertung
machen	machen
molekulare	molekulare
Sprengstoffgesetz	Sprengstoffgesetz
Lindau	Lindau
Kreher	Kreher
Erwin	Erwin
Kultursubstraten	Kultursubstraten
Esser	Esser
Schumann	Schumann
visuelle	visuell
Komplementärbeteiligung	Komplementärbeteiligung
landwirtschaftliche	landwirtschaftlich
Autokranen	Autokranen
ud	ud
umfaßt	umfassen
Borkheide	Borkheide
Wege	Weg
Friedersdorf	Friedersdorf
Kommanditgesellschaften	Kommanditgesellschaft
Wielenbach	Wielenbach
selbständiges	selbständig
Teamarbeit	Teamarbeit
Papenburg	Papenburg
Maurerhandwerkes	Maurerhandwerkes
Verleihrechten	Verleihrechten
Dreger	Dreger
angebotenen	angeboten
Bebauungsplanes	Bebauungsplan
Grahl	Grahl
sowohl	sowohl
Aloysius	Aloysius
Schocke	Schocke
Jütro	Jütro
Greuzinger	Greuzinger
Tonbaustoffe	Tonbaustoffe
Abschnitts	Abschnitt
Rüdersdorf	Rüdersdorf
Quellmelz	Quellmelz
Neubeeren	Neubeeren
Objekten	Objekt
errichten	errichten
zusammenhängen	zusammenhängen
Battista	Battista
weiter	weiter
verbunden	verbunden
Straßenbaus	Straßenbau
Fremdverbrauch	Fremdverbrauch
zum	zum
Josef	Josef
Woköck	Woköck
jeglicher	jeglich
Rudolf	Rudolf
Transportarbeiten	Transportarbeiten
Versorgung	Versorgung
Wirtschaftsstruktur	Wirtschaftsstruktur
XABU	XABU
zwischen	zwischen
ECC	ECC
Erbringung	Erbringung
Karriereberatung	Karriereberatung
Erwerbs	Erwerb
Sportlehrer	Sportlehrer
Computer	Computer
Gästen	Gast
Winterdienstleistungen	Winterdienstleistungen
Sergey	Sergey
Persönlich	persönlich
Bötzow	Bötzow
Buchow	Buchow
Pflanzenhandel	Pflanzenhandel
m.b.H.	m.b.H.
Gemeinschaft	Gemeinschaft
Hebebühnen	Hebebühne
Abgabe	Abgabe
Hammerstein	Hammerstein
Gesa	Gesa
Jahncke	Jahncke
Gesundheits	Gesundheits
Betontechnik	Betontechnik
freiberuflich	freiberuflich
Malereibedarf	Malereibedarf
Anteilen	Anteilen
Ismaie	Ismaie
Baubetreuungsleistungen	Baubetreuungsleistungen
Gauff	Gauff
Darstellungen	Darstellung
Günter	Günter
Computersoftware	Computersoftware
Kuopio	Kuopio
Straße	Straße
Dekontaminierung	Dekontaminierung
Maklertätigkeit	Maklertätigkeit
a.d.	a.d.
Geschäftsanteile	Geschäftsanteil
Kathrin	Kathrin
Ferudun	Ferudun
Verpacken	Verpacken
Wittkowsky	Wittkowsky
Tabak	Tabak
Spirituosen	Spirituose
marktgängigen	marktgängig
Klinner	Klinner
Sawade	Sawade
Jung	Jung
Ermächtigung	Ermächtigung
Gastronomiebedarf	Gastronomiebedarf
Liewald	Liewald
FOOD	food
weitesten	weit
Instandsetzen	Instandsetzen
Vereins	Verein
Labortechnik	Labortechnik
BACKPACKERS	BACKPACKERS
bauausführenden	bauausführend
Fachgeschäften	Fachgeschäft
Auflösungsbeschluß	Auflösungsbeschluß
vollständig	vollständig
Lämmer	Lamm
Flurstück	Flurstück
besonderen	besonder
Genehmigungspflichtige	genehmigungspflichtig
jegliche	jeglich
Fischbach	Fischbach
beteiligen	beteiligen
stellen	stellen
Heckenbücker	Heckenbücker
Liebätz	Liebätz
Hammad	Hammad
Kremser	Kremser
Kaufen	Kaufen
Gabriele	Gabriele
Tischlermeister	Tischlermeister
FH	FH
Buchführungspflichten	Buchführungspflichten
Schroeter	Schroeter
Waldemar	Waldemar
Steuerungsanlagen	Steuerungsanlage
Stanislav	Stanislav
gesteuerter	gesteuert
Sanssouci	Sanssouci
Winterdienst	Winterdienst
Wehrhahn	Wehrhahn
Personengesellschaften	Personengesellschaft
Remscheid	Remscheid
Pessin	Pessin
Kunststoffen	Kunststoff
Ordnung	Ordnung
per	per
Grundstücksangelegenheiten	Grundstücksangelegenheit
Konditionstraining	Konditionstraining
Kienberg	Kienberg
Nädler	Nädler
Severine	Severine
Fresdorf	Fresdorf
Kundendienst	Kundendienst
Nielsen	Nielsen
Witthohn	Witthohn
Katharina	Katharina
Kosztandy	Kosztandy
Finanzkaufmann	Finanzkaufmann
Nitzschke	Nitzschke
Standort	Standort
Beratungs	Beratungs
gutachtliche	gutachtlich
Sicherheitsgewerbes	Sicherheitsgewerbe
Weiterhin	weiterhin
kaufmännischer	kaufmännisch
Kontaktlinsen	Kontaktlinsen
Rechtsgeschäfte	Rechtsgeschäft
Einzelfall	Einzelfall
jedoch	jedoch
Klausel	Klausel
Yacht	Yacht
Göttingen	Göttingen
Praxis	Praxis
haftenden	haftend
Pfarrern	Pfarrer
elektroakustischen	elektroakustisch
Anja	Anja
Grundsätzen	Grundsatz
Zeidler	Zeidler
Marx	Marx
Geldanlage	Geldanlage
Mengel	Mengel
Bochmann	Bochmann
gleichgestellten	gleichgestellt
Pietschmann	Pietschmann
Kontakt	Kontakt
Klein	Klein
Betriebs	Betrieb
Hartmut	Hartmut
Verwaltungsdienstleistungen	Verwaltungsdienstleistung
genehmigungsfreier	genehmigungsfreier
landschaftsgärtnerischen	landschaftsgärtnerischen
Belastung	Belastung
optische	optisch
Kiese	Kies
technischer	technisch
Arten	Arten
Ostheim	Ostheim
Telekommunikationstechnik	Telekommunikationstechnik
Datenbänken	Datenbank
Ömer	Ömer
Kanälen	Kanal
Rentsch	Rentsch
Rentco	Rentco
Teichsanierung	Teichsanierung
Breitbandkabelanlagen	Breitbandkabelanlagen
Ofenkacheln	Ofenkacheln
Drehortorganisation	Drehortorganisation
erwerben	erwerben
Observationen	Observation
Pöllwitz	Pöllwitz
Pizzaservice	Pizzaservice
tätige	tätig
Lachmann	Lachmann
Wildberg	Wildberg
soll	sollen
Krieg	Krieg
Prof	Prof
Vertriebsgesellschaften	Vertriebsgesellschaft
Steuerbegünstigte	Steuerbegünstigte
Teilbetrieb	Teilbetrieb
Dienste	Dienst
Dettloff	Dettloff
wohnwirtschaftliche	wohnwirtschaftliche
Prüfanlagen	Prüfanlage
unbebauter	unbebaut
Hoffmann	Hoffmann
verwendbaren	verwendbar
Redenz	Redenz
hohem	hoch
Vertretungen	Vertretung
Unrat	Unrat
kommunikationswissenschaftlicher	kommunikationswissenschaftlich
Entsorgungsmaßnahmen	Entsorgungsmaßnahme
Köhler	Köhler
technisch	technisch
sammeln	sammeln
Behrens	Behrens
Landmaschinenhandel	Landmaschinenhandel
Marketingstrategien	Marketingstrategie
Blechteilen	Blechteilen
Babelsberg	Babelsberg
persönliche	persönlich
Sabelus	Sabelus
Klempnerarbeiten	Klempnerarbeiten
Bruno	Bruno
Pufal	Pufal
Gewinnerzielung	Gewinnerzielung
verkaufsfördernder	verkaufsfördernd
Hellwig	Hellwig
Verwendung	Verwendung
Unternehmensberatung	Unternehmensberatung
Distribution	Distribution
Nebengeschäften	Nebengeschäft
Kundenstamm	Kundenstamm
firmierend	firmierend
Apparaten	Apparat
Vermögensteilen	Vermögensteilen
Inge	Inge
Betreibung	Betreibung
Konstruktionen	Konstruktion
Dächern	Dach
Margitta	Margitta
Jessen	Jessen
Burkhard	Burkhard
Gießen	Gießen
produktionstechnischen	produktionstechnisch
Abfallmengen	Abfallmengen
Umbauten	Umbauten
sanitären	sanitär
Anwendungsbereichen	Anwendungsbereich
Schönefeld	Schönefeld
Sendung	Sendung
Amtsdauer	Amtsdauer
Consulting	Consulting
Sliwka	Sliwka
Schaldach	Schaldach
Miercke	Miercke
Stukkateur	Stukkateur
finden	finden
Wulkau	Wulkau
Architektur	Architektur
Support	Support
erfolgen	erfolgen
Stammaktien	Stammaktie
lit	lit
Rekultivierungsmaßnahmen	Rekultivierungsmaßnahmen
Speisewirtschaft	Speisewirtschaft
Sachen	Sache
Sanitärinstallations	Sanitärinstallations
Verbraucherschutz	Verbraucherschutz
Eberswalde	Eberswald
Baulemente	Baulemente
Bauarten	Bauarten
verbundenen	verbunden
elektrotechnischen	elektrotechnisch
Ankauf	Ankauf
Stellplätzen	Stellplatz
Geschäftsvorfälle	Geschäftsvorfall
Hofreiter	Hofreiter
Halkyone	Halkyone
Begrünung	Begrünung
Gründungsprüfers	Gründungsprüfers
Seyferth	Seyferth
Maltzan	Maltzan
Imbißstuben	Imbißstube
Eigenbetrieb	Eigenbetrieb
Brodtmann	Brodtmann
England	England
Carsten	Carsten
Bücher	Buch
Ergebnisse	Ergebnis
Versand	Versand
Baureinigung	Baureinigung
Sauna	Sauna
Kraehe	Kraehe
Egenter	Egenter
Ersatzteilen	Ersatzteilen
baulichen	baulich
Bauplätzen	Bauplatz
Arie	Arie
Automatenaufstellung	Automatenaufstellung
Organisationsentwicklung	Organisationsentwicklung
Gegenstand	Gegenstand
fünfzehnte	fünfzehnte
Theisen	Theisen
DB	DB
Bensdorf	Bensdorf
Demontageleistungen	Demontageleistungen
Stavenhagen	Stavenhagen
Inneneinrichtungen	Inneneinrichtung
Projektmanagements	Projektmanagement
spezieller	speziell
Kiel	Kiel
diese	dies
Hameln	Hameln
Gesellschafterversammlungen	Gesellschafterversammlung
Mahlow	Mahlow
Appenzeller	Appenzeller
Stellvertretende	stellvertretend
Christinendorf	Christinendorf
freier	frei
Radtke	Radtke
handwerklichen	handwerklich
Pilzen	Pilz
Lohnleistungen	Lohnleistungen
Münich	Münich
Einsetzarbeiten	Einsetzarbeiten
Verringerung	Verringerung
Bo	Bo
D1	D1
Erziehung	Erziehung
Reichenbach	Reichenbach
Beuteln	Beuteln
Geschäftszweck	Geschäftszweck
Schiemenz	Schiemenz
Verwertungsgesellschaft	Verwertungsgesellschaft
Nudow	Nudow
Bügener	Bügener
Lübeck	Lübeck
veredelten	veredelt
Wohnungsbau	Wohnungsbau
Blüthgen	Blüthgen
Gegenstände	Gegenstand
tätigt	tätigen
Achte	Achte
Kienwerder	Kienwerder
fünf	fünf
Grundkapital	Grundkapital
Mietern	Mieter
Hausverwaltung	Hausverwaltung
übergeordneten	übergeordnet
Eilboten	Eilboten
Gesellschaftszwecks	Gesellschaftszwecks
zeitlinearen	zeitlinearen
DVD	DVD
mindenstens	mindenstens
Immobiliendienstleistungen	Immobiliendienstleistungen
Kinberger	Kinberger
Kober	Kober
Eichwalde	Eichwald
Sozial	sozial
K	K
Ein	ein
sonstiger	sonstig
Handelsvertreter	Handelsvertreter
Nguham	Nguham
Logistikbetrieb	Logistikbetrieb
Gesamtprokuristen	Gesamtprokuristen
Betreibergesellschaft	Betreibergesellschaft
START	Start
dahingehend	dahingehend
technische	technisch
Haus	Haus
Medienartikeln	Medienartikeln
Natursteinprodukten	Natursteinprodukten
Initiative	Initiative
vorzunehmen	vornehmen
Bestimmungen	Bestimmung
Regionaler	regional
Anschlußarbeiten	Anschlußarbeiten
Schlangen	Schlange
zweiten	zweit
Feinkost	Feinkost
Dresden	Dresden
festgelegten	festgelegt
Geschäftsvermögen	Geschäftsvermögen
Volfram	Volfram
Ausführungen	Ausführung
Kühling	Kühling
Verlustminimierung	Verlustminimierung
Zubehörartikeln	Zubehörartikeln
Job	Job
Restle	Restle
Produktionsverfahrens	Produktionsverfahren
Dolgenbrodt	Dolgenbrodt
modernen	modern
Fertigprodukte	Fertigprodukt
Eberhard	Eberhard
Eike	Eike
medizinische	medizinisch
Einlagen	Einlage
Satzungsänderung	Satzungsänderung
Köhne	Köhne
entstanden	entstehen
Trinkwasser	Trinkwasser
seiner	sein
Tallinn	Tallinn
m	m
Möbel	Möbel
SGE	SGE
Beschlüsse	Beschluß
Nicht	nicht
Hentzschel	Hentzschel
Wusterhausen	Wusterhausen
allem	alle
Rudolph	Rudolph
