# This file contains terms and their lemma forms as determined by the POS
# tagger TreeTagger. DIAsDEM Workbench 2.1 can only process single-token
# terms (e.g., 'ist') which do not contain blank spaces. Terms are not
# looked up case-sensitively. Hence, both terms 'ist' and 'IST' will be
# mapped onto the grammatical root 'sein'. Each line contains exactly one
# term and its lemma form separated by exactly one tab stop. This file was
# created by the DIAsDEM task Actions -> Prepare Data Set -> Lemmatize
# Text Units using the advanced option 'Create New Known Lemma Forms File'.
Deetz	Deetz
Dabendorf	Dabendorf
Bubner	Bubner
Raumtechnik	Raumtechnik
Rüsselsheim	Rüsselsheim
Steinbach	Steinbach
Gagzow	Gagzow
Leimen	Leimen
Nils	Nils
Jan	Jan
Franke	Franke
Lübbenau	Lübbenau
Festsetzungen	Festsetzung
Alex	Alex
Rationalisierung	Rationalisierung
Verfügungen	Verfügung
Zühlsdorf	Zühlsdorf
Puhlmann	Puhlmann
insweit	insweit
Verbesserung	Verbesserung
STRABAG	STRABAG
Schönhagen	Schönhagen
Sachvermögen	Sachvermögen
weitere	weit
lit.	Lit.
la	la
Lindenberg	Lindenberg
Höldtke	Höldtke
Switak	Switak
Kinder	Kind
EGV	EGV
Lippspringe	Lippspringe
Immobiliengeschäften	Immobiliengeschäft
Zu	zu
beteiligt	beteiligen
RPD	RPD
Charlottenburg	Charlottenburg
Kotzias	Kotzias
Trockenbau	Trockenbau
Heinzel	Heinzel
Swoboda	Swoboda
Elektro	Elektro
beschlossenen	beschlossen
Christa	Christa
Ellinor	Ellinor
Cordelia	Cordelia
Obst	Obst
Neufeld	Neufeld
Carglass	Carglass
Eiche	Eiche
Knauer	Knauer
Blvd	Blvd
Köln	Köln
Domagk	Domagk
Stefan	Stefan
Produktionsgesellschaft	Produktionsgesellschaft
Rolf	Rolf
Zwischenahn	Zwischenahn
Michalski	Michalski
sozialpädagogischen	sozialpädagogisch
Schröder	Schröder
Eisbeseitigung	Eisbeseitigung
Herford	Herford
Fricke	Fricke
Stralsund	Stralsund
Pflichten	Pflichten
Farrokhina	Farrokhina
Sondermaschinen	Sondermaschine
Gerau	Gerau
Zubehör	Zubehör
Wassertechnik	Wassertechnik
Zum	zum
Versatz	Versatz
dessen	d
Wirkung	Wirkung
Lücking	Lücking
Börner	Börner
Verkehr	Verkehr
OT	OT
Krefeld	Krefeld
Wartung	Wartung
Beirat	Beirat
UNITERRA	UNITERRA
Konrad	Konrad
Heidkamp	Heidkamp
Birkenstaedt	Birkenstaedt
Künicke	Künicke
entwickeln	entwickeln
Kanal	Kanal
Rodax	Rodax
Klemm	klemmen
Winckel	Winckel
Ausland	Ausland
Friebe	Friebe
California	California
Studien	Studien
Neitemeier	Neitemeier
Inhaber	Inhaber
Zimbo	Zimbo
Herklotz	Herklotz
Messerschmidt	Messerschmidt
bestellen	bestellen
Bautechnik	Bautechnik
Erlaubnis	Erlaubnis
Global	global
S.	S.
Trallo	Trallo
eingeräumten	eingeräumt
Voß	Voß
Grundstücke	Grundstück
Paragraphen	Paragraph
Ausgliederung	Ausgliederung
Langenhagen	Langenhagen
Stammeinlagen	Stammeinlagen
historischen	historisch
Massiv	Massiv
und	und
Währung	Währung
Garantie	Garantie
Wesjohann	Wesjohann
Schwaiger	Schwaiger
Apeldoorn	Apeldoorn
Begleitung	Begleitung
Service	Service
Verlags	Verlag
Infrastrukturen	Infrastruktur
Landkreis	Landkreis
Annahme	Annahme
Götsch	Götsch
Siewert	Siewert
tätigen	tätigen
Fachgroßhandlung	Fachgroßhandlung
Matzdorf	Matzdorf
Dick	Dick
Weichenbau	Weichenbau
Instandsetzungsmaßnahmen	Instandsetzungsmaßnahme
Winfried	Winfried
Aumüller	Aumüller
annehmen	annehmen
Zwecken	Zwecken
Muratovic	Muratovic
Körner	Körner
Gegenwert	Gegenwert
Abschlag	Abschlag
Verkehrsbauten	Verkehrsbau
Makler	Makler
Pluim	Pluim
Wietersheim	Wietersheim
entsprechenden	entsprechend
Import	Import
Kamp	Kamp
Landkreises	Landkreis
gewerblichen	gewerblich
Vincentus	Vincentus
Mittas	Mittas
Kumar	Kumar
Baumgardt	Baumgardt
Ausbaugewerbes	Ausbaugewerbe
Dipl.-Ing.	Dipl.-Ing.
Umwelttechnik	Umwelttechnik
Abschlusses	Abschluß
Sokolov	Sokolov
Sterner	Sterner
Hensel	Hensel
Gardinen	Gardine
Herzog	Herzog
Nematollah	Nematollah
Kommandisten	Kommandisten
Hirsch	Hirsch
Niedernhausen	Niedernhausen
Oliver	Oliver
Ausbauarbeiten	Ausbauarbeiten
press	press
Falkensee	Falkensee
Fristablaufes	Fristablaufes
Kienitz	Kienitz
wieder	wieder
Burschik	Burschik
Kuntze	Kuntze
Projektierungs	Projektierungs
Palm	Palm
Ralph	Ralph
Wandelgenußrechte	Wandelgenußrechte
positiver	positiv
festzusetzenden	festzusetzend
GaWa	GaWa
Gewerbebauten	Gewerbebau
Yat	Yat
Neuenhagen	Neuenhagen
Bausystemen	Bausystemen
Kleinmachnow	Kleinmachnow
Fliesen	Fliesen
Halberstadt	Halberstadt
Heymann	Heymann
Böttcher	Böttcher
Brusendorf	Brusendorf
Jahn	Jahn
pro	pro
Wietstock	Wietstock
Anfangswert	Anfangswert
Einlage	Einlage
Abhaltung	Abhaltung
wegen	wegen
Entwicklung	Entwicklung
Geschäftsführer	Geschäftsführer
Madel	Madel
dreijährigen	dreijährig
Löschungsgesetzes	Löschungsgesetzes
Prozentsatz	Prozentsatz
bei	bei
Gesamtvollstreckungsverfahren	Gesamtvollstreckungsverfahren
Fleurance	Fleurance
Kliemke	Kliemke
Lütfü	Lütfü
Bewertung	Bewertung
ungekündigten	ungekündigt
Prokoph	Prokoph
Hajesch	Hajesch
Abele	Abele
Beiputz	Beiputz
Verordnung	Verordnung
GAIFAR	GAIFAR
Ravensburg	Ravensburg
Referenzperiode	Referenzperiode
Krummensee	Krummensee
Pauli	Pauli
so	so
Breuer	Breuer
Risse	Riß
zugelassene	zugelassen
Halsbek	Halsbek
Anfügung	Anfügung
Anlage	Anlage
Reckziegel	Reckziegel
Methodik	Methodik
Pastucha	Pastucha
außerbetriebliche	außerbetriebliche
Verwerten	Verwerten
Maibach	Maibach
Prenzel	Prenzel
Schwichtenberg	Schwichtenberg
Marco	Marco
Kunert	Kunert
UR	Ur
Erkenntnissen	Erkenntnis
Finanzierungsbearbeitung	Finanzierungsbearbeitung
Europe	Europe
rer.	rer.
Atef	Atef
Ergebnisabführungsvertrag	Ergebnisabführungsvertrag
Maschinen	Maschine
bleibt	bleiben
Wissenschaft	Wissenschaft
handels	Handel
abweichenden	abweichend
erhöhen	erhöhen
Materialien	Material
Silbe	Silbe
Gutbrod	Gutbrod
Hanno	Hanno
Einrichtungen	Einrichtung
Schwarz	Schwarz
Vorstamdsmitglieder	Vorstamdsmitglieder
Eckart	Eckart
eingezahlt	einzahlen
Laack	Laack
biomolekularer	biomolekularer
Roloff	Roloff
Dallgow	Dallgow
gelöscht	gelöscht
Siganur	Siganur
Nickert	Nickert
Elektrogeräten	Elektrogerät
Gudrun	Gudrun
Kay	Kay
Ruse	Ruse
Gerichtsstand	Gerichtsstand
Martina	Martina
Bocholt	Bocholt
Dritter	Dritte
Türscherl	Türscherl
Clemenz	Clemenz
Wulf	Wulf
gehören	gehören
Tero	Tero
mehrerer	mehrerer
wäre	sein
ermöglicht	ermöglichen
Erbfolge	Erbfolge
Stammeinlage	Stammeinlage
Menschen	Mensch
Gerüstbau	Gerüstbau
Partner	Partner
Ursel	Ursel
Teilschuldverschreibung	Teilschuldverschreibung
Petra	Petra
Handlungsbevollmächtigten	Handlungsbevollmächtigten
Scheibe	Scheibe
Böckelmann	Böckelmann
Tauber	Taube
Frachten	Fracht
ausschließen	ausschließen
Gründung	Gründung
Fahrerlaubnissen	Fahrerlaubnissen
IN	IN
Karla	Karla
Gesetz	Gesetz
Hockmann	Hockmann
Vicki	Vicki
Arndt	Arndt
West	West
Jack	Jack
Anker	ankern
Fritz	Fritz
Tuchen	Tuchen
Alois	Alois
Brandenburgische	Brandenburgische
Beckmann	Beckmann
Henstedt	Henstedt
Umwelt	Umwelt
Frauke	Frauke
Europarc	Europarc
Rademacher	Rademacher
audiovisuellen	audiovisuell
MED	MED
Rauchbach	Rauchbach
Daur	Daur
Freizeit	Freizeit
Gala	Gala
Beratungsgesellschaft	Beratungsgesellschaft
Lindemann	Lindemann
Finanzierungsmitteln	Finanzierungsmitteln
Vertrag	Vertrag
Vergabe	Vergabe
of	of
Eigen	Eigen
Bewerbern	Bewerber
Vermögenswerten	Vermögenswerten
Kontinenten	Kontinent
Ruf	Ruf
Rehberg	Rehberg
Verbindlichkeiten	Verbindlichkeit
Brühl	Brühl
Kotte	Kotte
Regisstergericht	Regisstergericht
Städtebau	Städtebau
bebaute	bebaut
IUWW	IUWW
Schriever	Schriever
Emmission	Emmission
Bilanz	Bilanz
Verhoeven	Verhoeven
Wirtschaftsablaufs	Wirtschaftsablaufs
Sasse	Sasse
Mark	Mark
andere	ander
Körbner	Körbner
Jann	Jann
Agrarproduktion	Agrarproduktion
Calculator	Calculator
Heizung	Heizung
Feld	Feld
Poos	Poos
alternativer	alternativ
Bartling	Bartling
Knaack	Knaack
Büttner	Büttner
Steffek	Steffek
Giovanni	Giovanni
industrielle	industriell
Hinz	Hinz
Funkstreifendienst	Funkstreifendienst
Görlsdorf	Görlsdorf
beide	beide
Frickingen	Frickingen
Schrödter	Schrödter
Maukisch	Maukisch
Unger	Unger
Roswitha	Roswitha
Wandelschuldverschreibungen	Wandelschuldverschreibung
zweite	zweit
Sonderrechtsnachfolge	Sonderrechtsnachfolge
Dallgower	Dallgower
Hellmann	Hellmann
Harri	Harri
Arthur	Arthur
Odin	Odin
Bebauung	Bebauung
Tintelnot	Tintelnot
Haven	Haven
Hilfe	Hilfe
Holt	holen
Diehl	Diehl
Dickel	Dickel
Marcour	Marcour
Sitzverlegung	Sitzverlegung
Harz	Harz
OHG	OHG
Sittensen	Sittensen
Gernold	Gernold
Bauelementen	Bauelement
Urstromtal	Urstromtal
Andresen	Andresen
Gesellschaftszweck	Gesellschaftszweck
Luftfahrt	Luftfahrt
mittelständischen	mittelständisch
i.S.d.	i.S.d.
berichtigt	berichtigen
Zobel	Zobel
Medizintechnik	Medizintechnik
Zimpelmann	Zimpelmann
Gesamtvollstreckungsverfahrens	Gesamtvollstreckungsverfahren
Breter	Breter
Heß	Heß
Aufbau	Aufbau
Güterbewirtschaftungsgesellschaft	Güterbewirtschaftungsgesellschaft
PLG	PLG
Berghaus	Berghaus
Mohanlal	Mohanlal
Göbel	Göbel
Streichung	Streichung
höchstens	höchstens
Bertus	Bertus
Laesing	Laesing
Güterherstellung	Güterherstellung
ausgegebenen	ausgegeben
Annett	Annett
Noll	Noll
Bauten	Bau
Hansmann	Hansmann
Lasar	Lasar
Regeltechnik	Regeltechnik
Michelberger	Michelberger
Oldenburg	Oldenburg
Schnorrenberg	Schnorrenberg
schriftlich	schriftlich
Finanzan	Finanzan
Zentralsterilisationen	Zentralsterilisationen
Carl	Carl
Deichsel	Deichsel
Wirth	Wirth
Kisse	Kisse
Diefenthal	Diefenthal
des	d
Fahrzeugvertriebsgesellschaft	Fahrzeugvertriebsgesellschaft
Landschaftsgestaltung	Landschaftsgestaltung
Willy	Willy
titulierten	tituliert
Siebelist	Siebelist
PPT	PPT
erhalten	erhalten
Valk	Valk
Essen	Essen
Tiefbau	Tiefbau
Bethke	Bethke
umzutauschen	umtauschen
Zweite	Zweite
Richter	Richter
festgelegt	festlegen
Rapphahn	Rapphahn
dienende	dienend
folgenden	folgend
Amtsgerichts	Amtsgericht
Schönhoff	Schönhoff
Rossi	Rossi
Karlheinz	Karlheinz
Crampe	Crampe
Hecker	Hecker
Ausgabebetrag	Ausgabebetrag
Umtauschverhältnis	Umtauschverhältnis
öffentlichem	öffentlich
teamwork	Teamwork
Hastedt	Hastedt
Martin	Martin
Schwerpunkt	Schwerpunkt
gesetzlichen	gesetzlich
rechtskräftiger	rechtskräftig
ausgestellte	ausgestellt
Johann	Johann
erscheinen	erscheinen
Bezugsaktien	Bezugsaktien
Jo	Jo
Salm	Salm
Softwareentwicklungen	Softwareentwicklung
zur	zur
Lienig	Lienig
Mitarbeiter	Mitarbeiter
kleiner	klein
Meserole	Meserole
Abeler	Abeler
Clalüna	Clalüna
gemeinsame	gemeinsam
Gesellschaftszweckes	Gesellschaftszweckes
h	h
Lindner	Lindner
Schneverdingen	Schneverdingen
gefasst	gefasst
Konzeptionen	Konzeption
Schubert	Schubert
Demmer	Demmer
Erfüllung	Erfüllung
Bergfried	Bergfried
Schons	Schons
Haseloff	Haseloff
Auswirkungen	Auswirkung
Projektierung	Projektierung
sollten	sollen
sichern	sichern
Schwanekamp	Schwanekamp
berufsrechtlich	berufsrechtlich
Gläubiger	Gläubiger
innovative	innovativ
Hergenröther	Hergenröther
Geltow	Geltow
Kröger	Kröger
Es	es
Mering	Mering
Fittings	Fittings
Tätigkeitsgebieten	Tätigkeitsgebieten
besteht	bestehen
Kabus	Kabus
ZH	ZH
Maurer	Maurer
Jagenholz	Jagenholz
Kunden	Kunde
Assemblierung	Assemblierung
Holstein	Holstein
Meiling	Meiling
Dörfer	Dorf
Einzelvertretung	Einzelvertretung
Deutsch	deutsch
Friesack	Friesack
Technik	Technik
Fläming	Fläming
Nadler	Nadler
Sattelzug	Sattelzug
Gartzke	Gartzke
ViBra	ViBra
Ottmar	Ottmar
Kurt	Kurt
Wittke	Wittke
Günther	Günther
Geschäftsanteilen	Geschäftsanteilen
genommen	nehmen
Arbeiten	Arbeiten
Kraus	Kraus
Lotto	Lotto
Schaube	Schaube
mehrmals	mehrmals
Mete	Mete
Warchau	Warchau
ECU	ECU
fremder	fremd
Mason	Mason
Sinne	Sinn
Hebestreit	Hebestreit
Küper	Küper
Speichern	Speichern
Baugeräten	Baugerät
Ingolf	Ingolf
Gesetzes	Gesetz
Kadel	Kadel
Markenzeichen	Markenzeichen
außerordentliche	außerordentlich
Rückstände	Rückstand
Petersen	Petersen
Fachfirmen	Fachfirmen
Dementsprechend	dementsprechend
Ausgabe	Ausgabe
Aufsichtsrats	Aufsichtsrat
Habijan	Habijan
v.	von
Verbriefung	Verbriefung
Nutzung	Nutzung
ihrer	ihr
Creativ	Creativ
TERRA	TERRA
Birgit	Birgit
Kontrolle	Kontrolle
Hentzsch	Hentzsch
Bollmannsruh	Bollmannsruh
Köris	Köris
Electro	Electro
Erschließungs	Erschließungs
Rechtsträgers	Rechtsträger
H	H
Analyse	Analyse
Lösung	Lösung
Gert	Gert
Margraf	Margraf
Gorski	Gorski
Smitka	Smitka
abgelehnt	ablehnen
Douglas	Douglas
Kraftwerke	Kraftwerk
Wien	Wien
Bevölkerung	Bevölkerung
Maaß	Maaß
Euro	Euro
Nowaczyk	Nowaczyk
Baumaschinenverleih	Baumaschinenverleih
Umrechnung	Umrechnung
Begebung	Begebung
Rüdiger	Rüdiger
aktives	aktiv
Sascha	Sascha
Yavuz	Yavuz
Ziffern	Ziffer
Buchberg	Buchberg
geschlossene	geschlossen
Sektor	Sektor
Haftung	Haftung
Reindert	Reindert
Vorbereitung	Vorbereitung
Sicherheitsleistung	Sicherheitsleistung
Mohr	Mohr
Plus	Plus
Alfred	Alfred
Schlaak	Schlaak
Pfungstadt	Pfungstadt
Dienstleistungs	Dienstleistungs
Schäffer	Schäffer
Ländern	Land
Pingel	Pingel
Sitzes	Sitz
ordnungsgemäße	ordnungsgemäß
konfigurationen	Konfiguration
Hotel	Hotel
Jana	Jana
Werbeagentur	Werbeagentur
Lippisch	Lippisch
Änderungder	Änderungder
Konz	Konz
Signalanlagen	Signalanlage
W	W
Designentwicklung	Designentwicklung
Brünner	Brünner
Flur	Flur
dürfen	dürfen
Steuerung	Steuerung
K.	K.
Dobrikow	Dobrikow
Burhop	Burhop
Bezug	Bezug
Heidi	Heidi
ergreifen	ergreifen
Wiegand	Wiegand
Döllen	Döllen
Falk	Falk
Kruppe	Kruppe
Bauwerksverträgen	Bauwerksverträgen
Übernahmevertrages	Übernahmevertrag
Behinderteneinrichtungen	Behinderteneinrichtung
Windfeld	Windfeld
Emissionen	Emission
Amtsblatt	Amtsblatt
Slupinski	Slupinski
Eröhung	Eröhung
Bretten	Bretten
Eckner	Eckner
fachliche	fachlich
dieser	dies
Glauerdt	Glauerdt
Optionsbedingungen	Optionsbedingungen
Grosse	Grosse
Kommanditsten	Kommanditsten
Woywod	Woywod
Ausstellungsbau	Ausstellungsbau
Marko	Marko
Bier	Bier
Koopmann	Koopmann
Liane	Liane
GmbH	GmbH
Kapitalien	Kapital
molekularbiologischen	molekularbiologischen
Höfke	Höfke
gerundet	runden
umweltverträgliche	umweltverträglich
Gerisch	Gerisch
Kroll	Kroll
Bucke	Bucke
Frenzel	Frenzel
Alfons	Alfons
Andert	Andert
Notars	Notar
risk	risk
Blank	Blank
Veröffentlichung	Veröffentlichung
Kassel	Kassel
Santa	Santa
bebauten	bebaut
Annemarie	Annemarie
Niederwerbig	Niederwerbig
Guido	Guido
Pierre	Pierre
amm	amm
Kommunikation	Kommunikation
Reinhold	Reinhold
Art	Art
sämtliche	sämtlich
Abwasserver	Abwasserver
Realisierungsleistungen	Realisierungsleistungen
Doering	Doering
Nachunternehmer	Nachunternehmer
keinen	kein
während	während
DRS	DRS
Waldstadt	Waldstadt
Nachweis	Nachweis
Pfisterer	Pfisterer
Stammkapital	Stammkapital
Halle	Halle
Zuführung	Zuführung
Hollenstedt	Hollenstedt
Reck	Reck
verschieben	verschieben
Telekommunikationsgesellschaft	Telekommunikationsgesellschaft
Tamm	Tamm
Günnemann	Günnemann
Konkurses	Konkurs
Walther	Walther
Vermögensverwaltungsgesellschaft	Vermögensverwaltungsgesellschaft
Internationale	international
Hendrik	Hendrik
Goldmann	Goldmann
Sozialgesetzbuch	Sozialgesetzbuch
Nürtingen	Nürtingen
Damit	damit
begründeten	begründen
erforderlich	erforderlich
Menzel	Menzel
Erbe	Erbe
Unternehmenszweck	Unternehmenszweck
Gunter	Gunter
Niebling	Niebling
liegenden	liegend
Holding	Holding
Dönüs	Dönüs
Machnitzke	Machnitzke
Looks	Looks
erworbenen	erworben
Ultes	Ultes
Umfang	Umfang
Freise	Freise
Blankensee	Blankensee
Alleineigentümer	Alleineigentümer
Baureifmachung	Baureifmachung
Abbruchmaterial	Abbruchmaterial
Unternehmensverwaltung	Unternehmensverwaltung
Helgert	Helgert
Weise	Weise
Grundstücken	Grundstück
wissenschaftlichen	wissenschaftlich
Hauser	Hauser
WINGS	WINGS
Stuhr	Stuhr
Vetterlein	Vetterlein
Handelsgesellschaft	Handelsgesellschaft
Pieper	Pieper
Brunckhorst	Brunckhorst
auszuschließen	ausschließen
Kaya	Kaya
Autohaus	Autohaus
Griesel	Griesel
Büromaschinen	Büromaschine
Hardenberg	Hardenberg
Schmelling	Schmelling
Osecom	Osecom
Ludger	Ludger
Buschke	Buschke
Eggert	Eggert
Honeywell	Honeywell
Stoklossa	Stoklossa
Installationen	Installation
Weißbrod	Weißbrod
Walloschke	Walloschke
Brand	Brand
Semlin	Semlin
Prieros	Prieros
St	St
Kleis	Kleis
Wild	Wild
Bilanzgesetz	Bilanzgesetz
dem	d
Schäff	Schäff
logistischen	logistisch
Arora	Arora
Hinblick	Hinblick
Seestern	Seestern
Gesellscshaft	Gesellscshaft
Borkwalde	Borkwalde
Tilman	Tilman
Telekommunikations	Telekommunikations
Gielen	Gielen
SN	SN
Offene_Handelsgesellschaft	Offene_Handelsgesellschaft
umgestellte	umgestellt
Hohn	Hohn
Mitglieder	Mitglied
Ferch	Ferch
verbundenden	verbundenden
wurden	werden
Dip	Dip
Steinen	Steinen
Weber	Weber
im	im
Verschmelzungsvertrag	Verschmelzungsvertrag
Sanitär	sanitär
durchschnittlichen	durchschnittlich
unmittelbar	unmittelbar
Olsberger	Olsberger
Sündermann	Sündermann
Stolle	Stolle
Unterschiedsbetrag	Unterschiedsbetrag
Hannes	Hannes
Radewege	Radewege
Mandy	Mandy
Kapitalanlagen	Kapitalanlage
Gruppe	Gruppe
Stief	Stief
Ziebell	Ziebell
Salvatore	Salvatore
Hackel	Hackel
Außenbereich	Außenbereich
Gewinnung	Gewinnung
Pohlmann	Pohlmann
technology	technology
ergeben	ergeben
Medienstadt	Medienstadt
Hohenroda	Hohenroda
Notliquidator	Notliquidator
Institutionen	Institution
Fetzer	Fetzer
Vermögensverwaltung	Vermögensverwaltung
Gewerbeordnung	Gewerbeordnung
Monaten	Monat
Strupat	Strupat
Ebenso	ebenso
IMVERMA	IMVERMA
Iris	Iris
Freund	Freund
Instandhaltung	Instandhaltung
Olaf	Olaf
Falle	Falle
ergibt	ergeben
Rosenberg	Rosenberg
beratenden	beratend
FGG	FGG
Baitz	Baitz
Graf	Graf
Helena	Helena
Matzinger	Matzinger
Wandlungsrecht	Wandlungsrecht
Bardenitz	Bardenitz
Konversion	Konversion
Wach	wach
Nordenham	Nordenham
unterstützen	unterstützen
Vorstandes	Vorstand
Qualitätszeichen	Qualitätszeichen
ff.	ff.
Remagen	Remagen
Einzelverbriefung	Einzelverbriefung
Spiel	Spiel
Römer	Römer
Buchholz	Buchholz
Geyer	Geyer
knowLogy	knowLogy
Euskirchen	Euskirchen
Betreuungs	Betreuungs
Manfred	Manfred
ist	sein
Lünstroth	Lünstroth
Antiele	Antiele
Nachtragsliquidator	Nachtragsliquidator
Verkehrsgesellschaft	Verkehrsgesellschaft
Gastronomie	Gastronomie
Erbbaurechte	Erbbaurechte
Giesert	Giesert
Großmaischeid	Großmaischeid
Reinigungsdienste	Reinigungsdienst
Bröcking	Bröcking
auszugeben	ausgeben
Teppiche	Teppich
System	System
Anträgen	Antrag
Installations	Installations
Altes	Altes
Förster	Förster
Konfektion	Konfektion
Wetzel	Wetzel
Rechterfeld	Rechterfeld
Venhorst	Venhorst
Aalen	Aalen
Olsberg	Olsberg
anderen	ander
welche	welch
Gegenstandes	Gegenstand
Blaschnick	Blaschnick
betreiben	betreiben
kommunaler	kommunal
contura	contura
Holger	Holger
Forschungsinfrastruktur	Forschungsinfrastruktur
Bauausführungsgesellschaft	Bauausführungsgesellschaft
Knappstein	Knappstein
Einzelprokuristin	Einzelprokuristin
erste	erst
Leonardo	Leonardo
Vornweg	vornweg
Totzek	Totzek
Aller	Aller
Bauplanung	Bauplanung
Hetzke	Hetzke
Sonderrechtsfolge	Sonderrechtsfolge
Kommanditistin	Kommanditistin
umfassend	umfassend
Kodal	Kodal
Konsumgüter	Konsumgut
Geschäftsräume	Geschäftsraum
Speckenmeyer	Speckenmeyer
Kliniken	Klinik
Tettnang	Tettnang
Grundeigentum	Grundeigentum
Digital	digital
Tankfahrzeug	Tankfahrzeug
Lang	Lang
Havelland	Havelland
Struktur	Struktur
Bauträgergesellschaft	Bauträgergesellschaft
gem.	gem.
Augsburg	Augsburg
Abwasserbeseitigung	Abwasserbeseitigung
Dörrschuck	Dörrschuck
neben	neben
Vormweg	Vormweg
Lüdersdorf	Lüdersdorf
Meckbach	Meckbach
bedingten	bedingt
Jeserig	Jeserig
Iserlohn	Iserlohn
Wilko	Wilko
Emmi	Emmi
Straßenbauarbeiten	Straßenbauarbeiten
Fürstenwalde	Fürstenwald
Thies	Thies
Telekommunikation	Telekommunikation
Frederic	Frederic
teilweisen	teilweise
Vorhaben	Vorhaben
Schulz	Schulz
Wittleder	Wittleder
Infrastruktur	Infrastruktur
Sattelaufleger	Sattelaufleger
Tangerhütte	Tangerhütte
Limburgerhof	Limburgerhof
Liquidation	Liquidation
Brandenburg	Brandenburg
Abt.	Abt.
Behindertentransport	Behindertentransport
Mittels	Mittel
Betriebsführung	Betriebsführung
Amend	Amend
Holland	Holland
Wärme	Wärme
Metz	Metz
Wandlungsfrist	Wandlungsfrist
Schaumann	Schaumann
Sylwia	Sylwia
Paris	Paris
Auslande	Ausland
Erd	Erd
ausgegliedert	ausgliedern
zuzüglich	zuzüglich
Dargo	Dargo
Kabeln	Kabeln
Geschäftsführerin	Geschäftsführerin
Inhabers	Inhaber
Anita	Anita
Brückner	Brückner
Siegfried	Siegfried
Finanzanlagen	Finanzanlage
vorbezeichneten	vorbezeichnet
Bartoszak	Bartoszak
Hempe	Hempe
Erwerbern	Erwerber
Einbringung	Einbringung
Paritätischen	Paritätische
entspricht	entsprechen
nachfolgend	nachfolgend
vorsehen	vorsehen
wirtschaftlichen	wirtschaftlich
Biomedical	Biomedical
Mosch	Mosch
Zschämisch	Zschämisch
Belschner	Belschner
Reichherzer	Reichherzer
solche	solch
Versorgungs	Versorgungs
USA	USA
Riehm	Riehm
Genehmigte	Genehmigte
Umstrukturierungen	Umstrukturierung
Übertrages	Übertrages
Heckmann	Heckmann
Münster	Münster
Schulze	Schulze
Gawlich	Gawlich
Rechtsträgerin	Rechtsträgerin
mobilen	mobil
lfd.	lfd.
Landesentwicklungsgesellschaft	Landesentwicklungsgesellschaft
Neue	neu
Kommunikationstechnologien	Kommunikationstechnologie
ergänzt	ergänzen
verlangen	verlangen
Halbestadt	Halbestadt
Kronberg	Kronberg
Urbanietz	Urbanietz
Einzelheiten	Einzelheit
derartige	derartig
unbebaute	unbebaut
analoger	analog
Wenzel	Wenzel
Addezi	Addezi
Normann	Normann
Marlen	Marlen
Danders	Danders
Bergunde	Bergunde
Saarmund	Saarmund
Dritten	Dritte
Kortenbrede	Kortenbrede
Gärtig	Gärtig
Mittenwalde	Mittenwald
HRA	HRA
Möller	Möller
Schlunke	Schlunke
Steuer	Steuer
Oder	oder
Teileigentum	Teileigentum
zulässigen	zulässig
Worbs	Worb
hort	Hort
Klee	Klee
Eingefügt	eingefügt
Kotras	Kotras
Jurecka	Jurecka
Sportplatzanlagen	Sportplatzanlagen
Treuhänder	Treuhänder
Neuhaus	Neuhaus
Ragow	Ragow
IPMG	IPMG
Nr.	Nr.
Künstler	Künstler
Kaulisch	Kaulisch
analog	analog
Geselschafterin	Geselschafterin
Rulands	Rulands
Floren	Floren
selben	selb
Bildung	Bildung
Methoden	Methode
Abeln	Abeln
Behnitz	Behnitz
Häuser	Haus
Niehus	Niehus
erfüllt	erfüllen
Martine	Martine
Hasselmann	Hasselmann
Gemüse	Gemüse
Baulichkeiten	Baulichkeit
Prediger	Prediger
Diamond	Diamond
Planungen	Planung
Hierzu	hierzu
Massivhaus	Massivhaus
oben	oben
Mack	Mack
Zwecke	Zwecke
speziell	speziell
Bereich	Bereich
Rando	Rando
Zoubtsov	Zoubtsov
Morof	Morof
Aus	Aus
Zuzahlung	Zuzahlung
Berghausen	Berghausen
Aydin	Aydin
erneute	erneut
bereitstellen	bereitstellen
weiterzuentwickeln	weiterentwickeln
Torsten	Torsten
Handwerk	Handwerk
Achim	Achim
Ogram	Ogram
pachten	pachten
Bauunternehmung	Bauunternehmung
Geschäftszweckes	Geschäftszweckes
Parcel	Parcel
Dembeck	Dembeck
Erdmann	Erdmann
Ganzes	Ganze
Baugerüsten	Baugerüst
Jahrling	Jahrling
EMWE	EMWE
Veit	Veit
wurde	werden
Starck	Starck
Nahrungsmittel	Nahrungsmittel
Linoleum	Linoleum
ES	es
Sylvia	Sylvia
Meye	Meye
Wöltinger	Wöltinger
HGB	HGB
Vermögen	Vermögen
Rosenträger	Rosenträger
Holzdesign	Holzdesign
vor	vor
Arbeitssicherheit	Arbeitssicherheit
Schöneiche	Schöneiche
Beuchler	Beuchler
Gesamtbetrag	Gesamtbetrag
Beschluß	Beschluß
Luftfahrzeugen	Luftfahrzeug
herrschender	herrschend
Schönholz	Schönholz
Zertifizierung	Zertifizierung
Mewes	Mewes
grundstücksgleichen	grundstücksgleichen
Wertentwicklung	Wertentwicklung
Materialflußoptimierung	Materialflußoptimierung
erteilt	erteilen
hieraus	hieraus
Drexl	Drexl
Baumann	Baumann
d	D
Anfügen	anfügen
Private	Private
Clasani	Clasani
Organe	Organ
Gesellschafter	Gesellschafter
Diamant	Diamant
Endprodukten	Endprodukt
Gut	Gut
Amts	Amt
Burkard	Burkard
Menzo	Menzo
AMRO	AMRO
Kläranlagenbau	Kläranlagenbau
Steuerberaterin	Steuerberaterin
übernehmer	Übernehmer
Blossin	Blossin
Borsdorf	Borsdorf
Rach	Rach
Hälfte	Hälfte
Mertz	Mertz
redaktionell	redaktionell
Winterberg	Winterberg
seine	sein
Frommholz	Frommholz
Fortak	Fortak
Wandelschuldverschreibung	Wandelschuldverschreibung
kontaminiertes	kontaminiert
Kuprian	Kuprian
Da	da
Serviceleistungen	Serviceleistung
beherrschende	beherrschend
aus	aus
bildet	bilden
Szczepanski	Szczepanski
Weihrauch	Weihrauch
inländischen	inländisch
Luftfahrtgerät	Luftfahrtgerät
Pacht	Pacht
Wohnungs	Wohnungs
LAGO	LAGO
Aurich	Aurich
Willemsen	Willemsen
Büromöbel	Büromöbel
Herbst	Herbst
Baumaterialien	Baumaterial
jeweils	jeweils
Frenz	Frenz
Herrmann	Herrmann
Geretsried	Geretsried
Rechtsträgerinnen	Rechtsträgerinnen
Tanja	Tanja
Unternehmensgegenstandes	Unternehmensgegenstandes
Dahme	Dahme
Godfrey	Godfrey
Agraringenieurökonom	Agraringenieurökonom
Betriebsgaststätte	Betriebsgaststätte
Gesamtprokuristin	Gesamtprokuristin
Zimmermann	Zimmermann
Pfullendorf	Pfullendorf
Wortmann	Wortmann
beendet	beenden
Baustoff	Baustoff
Paulinenhof	Paulinenhof
zugrunde	zugrunde
Genthin	Genthin
Schenkendorf	Schenkendorf
Versorgungstechnik	Versorgungstechnik
Glas	Glas
Betriebsüberlassungsvertrag	Betriebsüberlassungsvertrag
Verfahren	Verfahren
Zuge	Zug
entweder	entweder
EUR	EUR
rechtskräftigen	rechtskräftig
Wassermann	Wassermann
Hochmuth	Hochmuth
Entwicklungsträger	Entwicklungsträger
Spieß	Spieß
Krone	Krone
Ingenieurbüro	Ingenieurbüro
E.	E.
DM	DM
grundstücksgleiche	grundstücksgleich
Muttergesellschaft	Muttergesellschaft
Tilsner	Tilsner
Hirschfeld	Hirschfeld
betroffen	betreffen
Wüllner	Wüllner
unmittelbaren	unmittelbar
Ewili	Ewili
Drechsler	Drechsler
Moser	mosern
Onofrietti	Onofrietti
D	D
Cafe	Cafe
Gravemann	Gravemann
Löhne	Lohn
Januar	Januar
Verlegung	Verlegung
Unternehmensbeteiligungen	Unternehmensbeteiligung
Horn	Horn
LBN	LBN
Junkert	Junkert
Meinhard	Meinhard
eingereichten	eingereicht
Bausparverträgen	Bausparvertrag
Baugesellschaft	Baugesellschaft
Weiterer	weit
verpachten	verpachten
Kapitalgesellschaft	Kapitalgesellschaft
MHB	MHB
Tag	Tag
Sauermann	Sauermann
Spalte	Spalte
Landschaftsplanung	Landschaftsplanung
Kusch	Kusch
Sicherheitsdienste	Sicherheitsdienst
UND	UND
privatschriftlicher	privatschriftlicher
staatlichen	staatlich
errechnet	errechnen
Rubbert	Rubbert
allein	allein
bzw.	bzw.
begeben	begeben
ohne	ohne
Br.	Br.
Dentalgeräten	Dentalgeräten
Vorstehendem	Vorstehendem
Zwickau	Zwickau
Bootsverleih	Bootsverleih
Regionaleisenbahn	Regionaleisenbahn
Rölle	Rölle
Center	Center
Gerard	Gerard
Gelsenkirchen	Gelsenkirchen
treuhänderischer	treuhänderischer
einen	ein
Namen	Name
Sportartikel	Sportartikel
Räume	Raum
Registergericht	Registergericht
vermittelt	vermitteln
Gesellschafer	Gesellschafer
persönlichen	persönlich
Dombrowa	Dombrowa
DOMODUL	DOMODUL
Riemer	Riemer
Küber	Küber
Lange	Lange
Latocha	Latocha
arbeitslose	arbeitslos
Sporniak	Sporniak
Willimzik	Willimzik
Jüterbog	Jüterbog
Ausstattung	Ausstattung
Frankfurter	Frankfurter
Herwig	Herwig
Diagnostik	Diagnostik
TÜV	TÜV
Gerken	Gerken
Taufkirchen	Taufkirche
nat	nat
Bartel	Bartel
ganz	ganz
Rösrath	Rösrath
Tijmen	Tijmen
Gesellschaftsbeteiligung	Gesellschaftsbeteiligung
anteiligen	anteilig
Gesellschaft	Gesellschaft
Eckmaier	Eckmaier
Heiko	Heiko
Pufahl	Pufahl
nun	nun
Kapitalbeteiligungen	Kapitalbeteiligung
Steinle	Steinle
Umwandlung	Umwandlung
verlegt	verlegen
Kott	Kott
Leymann	Leymann
Markkleeberg	Markkleeberg
Antrages	Antrag
Salzer	Salzer
Andrea	Andrea
Rabiye	Rabiye
angedienten	angedient
Polyamid	Polyamid
Knut	Knut
Garten	Garten
Böckelühr	Böckelühr
Agrarproduktions	Agrarproduktions
SUVAJA	SUVAJA
Baureparatur	Baureparatur
Lerche	Lerche
Zuschlagstoffe	Zuschlagstoff
Wohn	wohnen
Homburg	Homburg
METALGLOBE	METALGLOBE
Budick	Budick
benachteiligten	benachteiligt
MBF	MBF
Bremer	Bremer
v.d.	v.d.
Dresdner	Dresdner
Grün	Grün
Gieschke	Gieschke
dementsprechend	dementsprechend
Strücker	Strücker
Grimmen	Grimme
BioEngineering	Bioengineering
Müritz	Müritz
Monaen	Monaen
Gesellschafterin	Gesellschafterin
vorgenommen	vornehmen
INVEST	INVEST
Königstein	Königstein
technischem	technisch
errichtet	errichten
Systemtechnik	Systemtechnik
Bauvorbereitung	Bauvorbereitung
Einrichtung	Einrichtung
Rösch	Rösch
Kino	Kino
betreffenden	betreffend
Wustermark	Wustermark
Donner	Donner
Kirchner	Kirchner
Freianlagen	Freianlage
umzustellen	umstellen
S	S
Alsdorf	Alsdorf
Zeesen	Zeese
Georg	Georg
Emstal	Emstal
Lessien	Lessien
Maire	Maire
Gebäudereiniger	Gebäudereiniger
Abwicklung	Abwicklung
Reparaturen	Reparatur
diesen	dies
Margit	Margit
Oevermann	Oevermann
Wilhelmus	Wilhelmus
mehr	mehr
Velbert	Velbert
bringt	bringen
Hollopp	Hollopp
gesetzlich	gesetzlich
aufnahmebereite	aufnahmebereit
Dagmar	Dagmar
Schönborn	Schönborn
DARO	DARO
bis	bis
Schüller	Schüller
umgerechnet	umrechnen
Pennecke	Pennecke
Verwertung	Verwertung
Frommhold	Frommhold
Einbrodt	Einbrodt
Strukturverbesserung	Strukturverbesserung
Lüftungstechnikarbeiten	Lüftungstechnikarbeiten
Kleemann	Kleemann
Dennert	Dennert
Innen	innen
Ritzel	Ritzel
Chilla	Chilla
Rinteln	Rinteln
Commerzbank	Commerzbank
Veranstaltungstechnik	Veranstaltungstechnik
auszunehmen	ausnehmen
Sachverständige	Sachverständige
Hanseatische	Hanseatische
ergäntz	ergäntz
Betriebsdirektor	Betriebsdirektor
Schrodt	Schrodt
Dimde	Dimde
Manthei	Manthei
Rastersondenmikroskopie	Rastersondenmikroskopie
Seddiner	Seddiner
BANA	BANA
Viktar	Viktar
Thomas	Thomas
Märker	Märker
Ehlert	Ehlert
Kommunen	Kommune
welcher	welch
Marina	Marina
Schlangenbad	Schlangenbad
Getränken	Getränk
Hachemi	Hachemi
Dechtow	Dechtow
Gewerbeobjekten	Gewerbeobjekt
Branche	Branche
Bauträgerschaft	Bauträgerschaft
Tiefbauarbeiten	Tiefbauarbeiten
GEO	GEO
Schimmel	Schimmel
Potok	Potok
Bamberg	Bamberg
Wolfgang	Wolfgang
angeboten	angeboten
Schorr	Schorr
Gewerbebetrieben	Gewerbebetrieb
neu	neu
Daber	Daber
Biewald	Biewald
ausreichender	ausreichend
Meyr	Meyr
Ferner	fern
durchführt	durchführen
Bauprojekte	Bauprojekt
ABN	ABN
Annahmestelle	Annahmestelle
Schönwalde	Schönwald
Inh.	Inh.
ordentlichen	ordentlich
Freiburg	Freiburg
Gummiböden	Gummiböden
Frankreich	Frankreich
Vereinbarung	Vereinbarung
Erzeugnissen	Erzeugnis
Informationstechnologie	Informationstechnologie
geschäftlichen	geschäftlich
Schack	Schack
Bauüberwachung	Bauüberwachung
alarm	Alarm
Brüning	Brüning
Ramon	Ramon
Großmann	Großmann
Möpert	Möpert
Anselm	Anselm
beschließen	beschließen
Zimmerei	Zimmerei
Mineralölprodukten	Mineralölprodukt
sowie	sowie
Nachfolge	Nachfolge
Kriege	Krieg
Teil	Teil
Bölter	Bölter
Bauverwaltung	Bauverwaltung
BSV	BSV
Betriebsmitteln	Betriebsmitteln
Archivare	Archivar
Lagerung	Lagerung
Aktionären	Aktionär
bisherige	bisherig
Selbstlosigkeit	Selbstlosigkeit
Bissendorf	Bissendorf
Nauheim	Nauheim
Macholz	Macholz
Gebraucht	gebraucht
leistende	leistend
sozialer	sozial
Ausübung	Ausübung
Sitzungen	Sitzung
muss	muss
Schaumburg	Schaumburg
Drees	Drees
Großziethen	Großziethen
Wandlungsverhältnis	Wandlungsverhältnis
Darüberhinaus	darüberhinaus
Trarbach	Trarbach
Lüftunganlagen	Lüftunganlagen
Zaccaria	Zaccaria
Sicherung	Sicherung
Maut	Maut
R	R
Wohnungsbaugesellschaft	Wohnungsbaugesellschaft
Wohnungswirtschaft	Wohnungswirtschaft
Kommunikationstechnik	Kommunikationstechnik
ausgeschlossen	ausschließen
Max	Max
Finanzierung	Finanzierung
Diedrich	Diedrich
Maria	Maria
Insolvenzverfahrens	Insolvenzverfahren
Übertragung	Übertragung
Hübner	Hübner
Back	Back
Medienprodukten	Medienprodukt
bringen	bringen
Öltanklager	Öltanklager
biologischer	biologisch
Glänzel	Glänzel
vollständige	vollständig
verwenden	verwenden
zusammenwirken	zusammenwirken
Silvio	Silvio
Weiss	Weiss
Pohle	Pohle
einzuräumen	einräumen
Ejdus	Ejdus
Schulung	Schulung
übernehmende	übernehmend
Energiesysteme	Energiesystem
Anspruch	Anspruch
erst	erst
elektronischen	elektronisch
alleiniger	alleinig
Kauf	Kauf
Klaus	Klaus
Vorstandsmitgliedern	Vorstandsmitglied
SIG	SIG
Egbert	Egbert
René	René
Ziel	Ziel
Technologie	Technologie
Breuhahn	Breuhahn
Deutscher	deutsch
Börsenkurs	Börsenkurs
Knesebeck	Knesebeck
Claus	Claus
Bauelemente	Bauelement
Sommerfeld	Sommerfeld
Friedhelm	Friedhelm
Gelbe	Gelbe
Lehrheuer	Lehrheuer
Ferdinand	Ferdinand
gesetzliche	gesetzlich
International	International
betätigt	betätigen
Neugründung	Neugründung
Pucks	Puck
Ihnen	Ihnen
wichtigen	wichtig
Grundstück	Grundstück
Ländchen	Ländchen
Proben	Proben
Dieterich	Dieterich
Ahnis	Ahnis
eingetreten	eintreten
Eingehen	Eingehen
ausländischen	ausländisch
beigefügt	beifügen
Falkenstern	Falkenstern
Joachim	Joachim
Sami	Sami
Muhl	Muhl
Rimpau	Rimpau
Alfter	Alfter
ausgeübt	ausüben
ausgeschieden	ausscheiden
niederlassungen	Niederlassung
gegenstandslos	gegenstandslos
Kreuzbruch	Kreuzbruch
organisatorischen	organisatorisch
Bleck	Bleck
Duscha	Duscha
PR	PR
Trillfingen	Trillfingen
Üzüm	Üzüm
Tölle	Tölle
Häring	Häring
Philippsthal	Philippsthal
ÖTAG	ÖTAG
Bleckhausen	Bleckhausen
Kade	Kade
beiden	beide
Umrechnungskurs	Umrechnungskurs
Wohlfahrtsverbandes	Wohlfahrtsverband
Lasten	Lasten
Wellmitz	Wellmitz
Dachelementen	Dachelementen
Erreichung	Erreichung
Ingo	Ingo
Hentschel	Hentschel
Seddin	Seddin
übertragen	übertragen
Danna	Danna
Options	Options
Maschke	Maschke
erfogt	erfogt
Filtingher	Filtingher
Kuhlmey	Kuhlmey
Auftrag	Auftrag
Helge	Helge
gerichtete	gerichtet
IV	IV
Zuganges	Zugang
Ivo	Ivo
entfällt	entfallen
Bauleistungen	Bauleistung
Biedermann	Biedermann
macht	machen
Gesellschafterbeschlüsse	Gesellschafterbeschlüsse
Hofer	Hofer
Fadeev	Fadeev
Eröffnung	Eröffnung
ausgeglichen	ausgleichen
Teilbetrages	Teilbetrages
Sozialzentren	Sozialzentren
bestehend	bestehend
Komstke	Komstke
Buschow	Buschow
Scheid	Scheid
Schweiz	Schweiz
Bebauungsplänen	Bebauungsplan
Herzberg	Herzberg
Klann	Klann
Phoenix	Phoenix
Stenzel	Stenzel
Beetz	Beetz
Akkaya	Akkaya
Lagern	Lagern
Wegen	wegen
nachfolgenden	nachfolgend
Demag	Demag
geschlossenen	geschlossen
Systemlösungen	Systemlösung
Haußer	Haußer
Henrik	Henrik
Taucha	Taucha
ALW	ALW
Bezugsrechtsausschluß	Bezugsrechtsausschluß
Verschmelzungsvertrages	Verschmelzungsvertrages
Performanceabschlags	Performanceabschlags
Wurl	Wurl
Göhlsdorf	Göhlsdorf
Wollin	Wollin
J.E.	J.E.
Slusar	Slusar
Tangermann	Tangermann
elektrischer	elektrisch
Informationsgesellschaft	Informationsgesellschaft
Postproduktion	Postproduktion
uneingeschränkt	uneingeschränkt
Marion	Marion
Mikhail	Mikhail
EDV	EDV
gemeinnützige	gemeinnützig
Daems	Daems
Gaststätten	Gaststätte
überschreitende	überschreitend
Ausscheidens	Ausscheiden
Krieger	Krieger
Errichtung	Errichtung
Rohrleitungsteilen	Rohrleitungsteilen
bedingt	bedingt
2a	2a
Abo	Abo
Gesamtvollstreckungseröffnung	Gesamtvollstreckungseröffnung
Verwaltung	Verwaltung
Bestensee	Bestensee
Henning	Henning
Ilona	Ilona
Abfälle	Abfall
langfristig	langfristig
Friedrich	Friedrich
Gollwitzer	Gollwitzer
Backwaren	Backware
vollständigen	vollständig
verehelichte	verehelichen
Bußmann	Bußmann
Wilfried	Wilfried
Woller	Woller
Reken	Reken
folgende	folgend
er	er
Kapitalanlagegesellschaft	Kapitalanlagegesellschaft
Krielow	Krielow
Stedtler	Stedtler
Bareinlagen	Bareinlage
Berufsbild	Berufsbild
Norf	Norf
Tochtermann	Tochtermann
verwandter	verwandt
Paderborn	Paderborn
Plessow	Plessow
genaue	genau
Meisterbetrieb	Meisterbetrieb
Modernisierung	Modernisierung
Jäschke	Jäschke
Borchardt	Borchardt
Niedernhall	Niedernhall
Kevin	Kevin
Siebrasse	Siebrasse
festzulegen	festlegen
vertritt	vertreten
Reinartz	Reinartz
Spiegelhalter	Spiegelhalter
Niehaus	Niehaus
Elstal	Elstal
Gregory	Gregory
Absatz	Absatz
Wolter	Wolter
Trockenbauarbeiten	Trockenbauarbeiten
Forderung	Forderung
Leonhardt	Leonhardt
eingetragen	eintragen
BW	BW
Seeburg	Seeburg
überwiegend	überwiegend
Kotzen	Kotzen
Einführungsgesetz	Einführungsgesetz
Svenja	Svenja
Handel	Handel
Spitzenbeträge	Spitzenbeträge
Nordprojekt	Nordprojekt
Haase	Haase
abzuschliessen	abzuschliessen
Immobiliengesellschaft	Immobiliengesellschaft
veräußern	veräußern
Pickert	Pickert
Scholz	Scholz
Co	Co
alleinvertretungsbefugt	alleinvertretungsbefugt
Hermes	Hermes
Pflichtenhefterstellungen	Pflichtenhefterstellungen
Schackert	Schackert
mittlere	mittler
Osterode	Osterode
Fischedick	Fischedick
Seifert	Seifert
Geräten	Gerät
Tiefbauingenieur	Tiefbauingenieur
Organschaftsvertrag	Organschaftsvertrag
Parkmöbeln	Parkmöbeln
Ausstattungsgeräten	Ausstattungsgeräten
fördernden	fördernd
Koordinierung	Koordinierung
Hoffstädt	Hoffstädt
gleichartigen	gleichartig
Servicetätigkeiten	Servicetätigkeiten
Heilstätten	Heilstätte
Klentzer	Klentzer
Wochen	Woche
Aalborg	Aalborg
Rehbrücke	Rehbrücke
Illinois	Illinois
Michendorf	Michendorf
Masse	Masse
Limeshain	Limeshain
Krahn	Krahn
Weller	Weller
Tagen	Tagen
ermächtigten	ermächtigt
Orlowski	Orlowski
Villemaire	Villemaire
Fensterbau	Fensterbau
nachzuweisen	nachweisen
Elektrizität	Elektrizität
Brillenlinsen	Brillenlinsen
Ückert	Ückert
Roese	Roese
Paulin	Paulin
Saßleben	Saßleben
Ausgabekurs	Ausgabekurs
Karsten	Karsten
c	C
Bodenbeläge	Bodenbelag
Reul	Reul
Wärmedienstleistungen	Wärmedienstleistungen
Schulzendorf	Schulzendorf
Erkrath	Erkrath
Neu	neu
Audits	Audits
Daten	Datum
Blaurock	Blaurock
Cottbus	Cottbus
Bedingungen	Bedingung
Koordination	Koordination
Voigt	Voigt
Waiblingen	Waiblingen
Wegener	Wegener
geleistet	leisten
Kristin	Kristin
Rogier	Rogier
reale	real
digitalen	digital
Ir	Ir
Beate	Beate
vermittelbaren	vermittelbar
Gründungsaufwand	Gründungsaufwand
Dem	d
Arnd	Arnd
Bezold	Bezold
dienen	dienen
Grundvermögens	Grundvermögen
jur.	jur.
Beteiligungs	Beteiligungs
eingetragener	eingetragen
Ingrid	Ingrid
Treuhandgesellschaft	Treuhandgesellschaft
Ausbildung	Ausbildung
Michaela	Michaela
Andreae	Andreae
Eintragungen	Eintragung
Berger	Berger
welches	welch
eingeräumt	einräumen
Berko	Berko
Jean	Jean
Holte	holen
Berliner	Berliner
genannt	nennen
Siering	Siering
Dieburg	Dieburg
Dahlewitz	Dahlewitz
Regina	Regina
Bibliothekare	Bibliothekar
Mohamed	Mohamed
Exner	Exner
Britz	Britz
Technische	technisch
internationalen	international
FiBu	FiBu
Vertriebsgesellschaft	Vertriebsgesellschaft
A	A
Bürocontainer	Bürocontainer
SUNNY	SUNNY
Waltrop	Waltrop
Gerüst	Gerüst
Damrow	Damrow
Deutschland	Deutschland
AVIONICS	AVIONICS
Beseitigung	Beseitigung
Ziffer	Ziffer
Gleiche	gleich
Handelstage	Handelstage
Europäische	europäisch
Beschlußfassung	Beschlußfassung
Mike	Mike
Nattheim	Nattheim
ermächtigt	ermächtigen
Spaltungsplanes	Spaltungsplanes
e.Kfm	e.Kfm
Paulinenaue	Paulinenaue
Gottschalk	Gottschalk
HB	HB
Prien	Prien
Horstfelde	Horstfelde
Optionsscheinen	Optionsscheinen
Olbrich	Olbrich
Scheithauer	Scheithauer
Warenhandel	Warenhandel
Cram	Cram
bekanntgemacht	bekanntgemacht
Mosler	Mosler
Nethe	Nethe
jweils	jweils
Moch	Moch
Boettger	Boettger
erloschen	erlöscht
Prognose	Prognose
Kähne	Kahn
Alzenau	Alzenau
TÜ	TÜ
Hinzmann	Hinzmann
Nordbahn	Nordbahn
Co.	Co.
Grünanlagenunterhaltung	Grünanlagenunterhaltung
Zusammenhang	Zusammenhang
Ernst	Ernst
fremde	fremd
landwirtschaftlichen	landwirtschaftlich
GLATEX	GLATEX
Servicegesellschaft	Servicegesellschaft
Ruppin	Ruppin
El	El
G.	G.
Schwäbisch	schwäbisch
Schönaich	Schönaich
Winter	Winter
übernommenen	übernommen
Spröer	Spröer
Höfner	Höfner
politischen	politisch
Fenstertechnik	Fenstertechnik
Baumaschinenhandel	Baumaschinenhandel
Parkplätzen	Parkplatz
Büge	Bug
Biebelmann	Biebelmann
Kommunikationssysteme	Kommunikationssystem
Optionspreises	Optionspreises
Sigurd	Sigurd
wirtschaftsfördernde	wirtschaftsfördernd
Mietobjekten	Mietobjekt
Ottens	Ottens
Susanne	Susanne
Mütter	Mutter
Hamm	Hamm
Meyerhof	Meyerhof
Ausnutzung	Ausnutzung
Slawomir	Slawomir
Ablaufs	Ablauf
Blau	Blau
Bezugsangebot	Bezugsangebot
Steinburg	Steinburg
Stöcker	Stöcker
Koglin	Koglin
Aktiensplits	Aktiensplits
Bevensen	Bevensen
Thierry	Thierry
Sondererbfolge	Sondererbfolge
Gebäudebereich	Gebäudebereich
Dessau	Dessau
Winkler	Winkler
Walzwerk	Walzwerk
Björn	Björn
unrichtiger	unrichtig
Porath	Porath
Dr.	Dr.
Renger	Renger
Rheine	Rheine
Ilmer	Ilmer
Jerucz	Jerucz
Teich	Teich
Massivwandelelemente	Massivwandelelemente
Rat	Rat
Romeo	Romeo
KG	KG
Gnann	Gnann
Reiter	Reiter
Höltershinken	Höltershinken
Eine	ein
Bachert	Bachert
Scholen	Scholen
Ausgliederungs	Ausgliederungs
Zepernick	Zepernick
übertragender	übertragender
Insbesondere	insbesondere
gesellschaftlichen	gesellschaftlich
Lieferung	Lieferung
Ehra	Ehra
Anke	Anke
umgewandelt	umwandeln
Instandhaltungs	Instandhaltungs
Geisleden	Geisleden
gesamte	gesamt
ACON	ACON
Thiel	Thiel
Wachschutz	Wachschutz
P	P
Specht	Specht
Medien	Medium
Krotz	Krotz
Oberflächenanlagen	Oberflächenanlagen
Kadira	Kadira
Stradmann	Stradmann
Emag	Emag
Managementberatung	Managementberatung
NL	NL
Baustahlmatten	Baustahlmatte
Maßgabe	Maßgabe
Trabandt	Trabandt
Entgelt	Entgelt
Seidel	Seidel
Selle	Selle
Übergang	Übergang
diesem	dies
Montage	Montage
erstreckt	erstrecken
Einkauf	Einkauf
York	York
Freddy	Freddy
Änderung	Änderung
Risikokapital	Risikokapital
Kaufmann	Kaufmann
Ebe	Ebe
Inger	Inger
erfolgte	erfolgt
Energietechnik	Energietechnik
inländischer	inländisch
André	André
letzten	letzt
mittelständische	mittelständisch
ausschließlich	ausschließlich
Wilhelm	Wilhelm
hier	hier
könne	können
Hikmet	Hikmet
Mehrheitsbeteiligungsgesellschaften	Mehrheitsbeteiligungsgesellschaften
Schenek	Schenek
Loest	Loest
Pennerstorfer	Pennerstorfer
Ingenieurgesellschaft	Ingenieurgesellschaft
Schirmer	Schirmer
wodurch	wodurch
Prokurist	Prokurist
GbR	GbR
Unter	unter
Gesellschaften	Gesellschaft
Stüve	Stüve
Form	Form
Kauffrau	Kauffrau
Hendriks	Hendriks
verschiedene	verschieden
Peters	Peters
Irmler	Irmler
Uwe	Uwe
Werder	Werder
Performanceabschlag	Performanceabschlag
Informationstechnik	Informationstechnik
Farben	Farbe
nach	nach
Auskunftei	Auskunftei
Ing.	Ing.
Darlehnsrückzahlungsansprüche	Darlehnsrückzahlungsansprüche
Saar	Saar
Prokura	Prokura
Busch	Busch
Sind	sein
Düring	Düring
Münchehofe	Münchehofe
Oelsner	Oelsner
Rogoschinski	Rogoschinski
Ausrüstung	Ausrüstung
befugt	befugt
Kriele	Kriele
Teilen	Teilen
Aufstockung	Aufstockung
Mende	Mende
sonstige	sonstig
Gesellschafterbeschlusses	Gesellschafterbeschlusses
e.K.	e.K.
festgesetzt	festsetzen
Höhne	Höhne
Bonn	Bonn
habil.	habil.
Grünwald	Grünwald
Transporten	Transport
Bauteilen	Bauteilen
VCC	VCC
Rust	Rust
Anstellungsverhältnis	Anstellungsverhältnis
Geschäft	Geschäft
Adalbert	Adalbert
Königer	Königer
letztlich	letztlich
Training	Training
Schlothauer	Schlothauer
gefaßt	fassen
4b	4b
gemeinnützigen	gemeinnützig
Dreusicke	Dreusicke
Waltraud	Waltraud
Blum	Blum
Satz	Satz
Bohlen	Bohle
Deutschbaselitz	Deutschbaselitz
Prinz	Prinz
verwandte	verwandt
Gesellschaftmit	Gesellschaftmit
Peri	Peri
Rütz	Rütz
Haustechnik	Haustechnik
alleinvertretungsberechtigt	alleinvertretungsberechtigt
Schönemann	Schönemann
dividendenabhängige	dividendenabhängige
Mavberg	Mavberg
Dosse	Dosse
MCL	MCL
Forschungsprojekten	Forschungsprojekt
Frings	Frings
abgeschlossene	abgeschlossen
Jacobus	Jacobus
einzelvertretungsbefugt	einzelvertretungsbefugt
Fürth	Fürth
Röhrig	Röhrig
berechneten	berechnet
Dieter	Dieter
Rauxel	Rauxel
Sozialdienste	Sozialdienst
Blitzschutzanlagen	Blitzschutzanlage
Fertigerzeugnissen	Fertigerzeugnissen
resultierenden	resultierend
Ruszczynski	Ruszczynski
aller	alle
Enrico	Enrico
geschäftsansässig	geschäftsansässig
Willmann	Willmann
rückwirkend	rückwirkend
Handwerksordnung	Handwerksordnung
Car	Car
AGRAR	AGRAR
Prof._Dr	Prof._Dr
New	New
Aufsichtsrates	Aufsichtsrat
Armin	Armin
zweiter	zweit
Urkunden	Urkunde
Jones	Jones
Prokuren	Prokuren
Abschluss	Abschluss
umgerechneten	umgerechnet
Bezugsrechte	Bezugsrechte
Bei	bei
Jochen	Jochen
Containern	Container
Ort	Ort
Touristik	Touristik
Cindy	Cindy
Teresa	Teresa
Vermieter	Vermieter
Jonas	Jonas
besonders	besonders
Herrsching	Herrsching
Gesundheit	Gesundheit
insoweit	insoweit
Kältetechnik	Kältetechnik
Draack	Draack
Friesl	Friesl
Hellmig	Hellmig
aufgerundet	aufrunden
Pratt	Pratt
berufsschulischen	berufsschulisch
Vorschrift	Vorschrift
Bukovsky	Bukovsky
Roswita	Roswita
Fettke	Fettke
Phenn	Phenn
Zeugmann	Zeugmann
Kirchhain	Kirchhain
Arbeitsbühnen	Arbeitsbühnen
Focke	Focke
STUDIOS	Studio
Kriesten	Kriesten
Jatzko	Jatzko
Freiberg	Freiberg
garantieren	garantieren
Zaleska	Zaleska
Elektroanlagen	Elektroanlage
Personalangelegenheiten	Personalangelegenheit
Grassow	Grassow
wenn	wenn
Wildenbruch	Wildenbruch
Süßenbach	Süßenbach
Amtsgericht	Amtsgericht
Stopp	Stopp
e.	e.
Recycling	Recycling
vorgenannten	vorgenannt
beschlossen	beschließen
Rehfelde	Rehfelde
gewähren	gewähren
a	A
Strukturwandels	Strukturwandel
Jeannette	jeannett
Sanierung	Sanierung
sie	sie
Diplom	Diplom
Offsetdruckerei	Offsetdruckerei
Adam	Adam
Goossens	Goossens
ALUTEX	ALUTEX
Lößner	Lößner
fallen	fallen
Stückaktien	Stückaktien
Natursteinbearbeitung	Natursteinbearbeitung
Neufassung	Neufassung
zusammenhängenden	zusammenhängend
Ermengerst	Ermengerst
Eckert	Eckert
umgestellt	umstellen
Kretschmer	Kretschmer
benötigen	benötigen
Kretzmann	Kretzmann
Akademiker	Akademiker
Durchschnittswerte	Durchschnittswert
behaupten	behaupten
Ausschluss	Ausschluss
Telz	Telz
mehrfach	mehrfach
Motzen	Motzen
Planung	Planung
Witzke	Witzke
Bensch	Bensch
arbeitsmarktpolitischen	arbeitsmarktpolitisch
Netfox	Netfox
Lotte	Lotte
Maintenance	Maintenance
Frankfurt	Frankfurt
denen	d
dort	dort
Niethammer	Niethammer
Landwirtschaftliche	landwirtschaftlich
Waldenmaier	Waldenmaier
DR	DR
berechtigten	berechtigt
Schrank	Schrank
Bauschlußreinigungen	Bauschlußreinigungen
Derdau	Derdau
vier	vier
Gubin	Gubin
Unternehmensberater	Unternehmensberater
Lager	Lager
Weigel	Weigel
Beelitz	Beelitz
UVA	UVA
Reinke	Reinke
abgewiesen	abweisen
Oberflächengestaltung	Oberflächengestaltung
Dussmann	Dussmann
Friseurmeisterin	Friseurmeisterin
Jutta	Jutta
Fränkl	Fränkl
Betriebswirt	Betriebswirt
Gmünd	Gmünd
M96	M96
Füßling	Füßling
Ursula	Ursula
Umweltschutz	Umweltschutz
Johanna	Johanna
diverse	divers
öffentlich	öffentlich
natürlichen	natürlich
Borgsdorf	Borgsdorf
Bauprojektierung	Bauprojektierung
Bergmann	Bergmann
einzige	einzig
Selectronic	Selectronic
Blume	Blume
Glienicke	Glienicke
jungen	jung
Ausgabepreises	Ausgabepreises
Gaststättenbetriebs	Gaststättenbetriebs
übertragung	Übertragung
Lieto	Lieto
Rasch	rasch
Schultz	Schultz
Azdasht	Azdasht
Steinkamp	Steinkamp
Arbeitsförderungsgesellschaft	Arbeitsförderungsgesellschaft
Zschieschang	Zschieschang
Börsentage	Börsentag
bar	bar
Nennbetragsaktien	Nennbetragsaktien
Spannring	Spannring
Serge	Serge
Erschließung	Erschließung
Milde	Milde
Hans	Hans
Länder	Land
mittelbar	mittelbar
eines	ein
Christfried	Christfried
Absätze	Absatz
Feigel	Feigel
Gisela	Gisela
Pfaffe	Pfaffe
Frankfurt_am_Main	Frankfurt_am_Main
besondere	besonder
Ratingen	Ratingen
Maximilian	Maximilian
beurkundet	beurkunden
STOXX	STOXX
Rüster	Rüster
Wallmeyer	Wallmeyer
druckpunkt	Druckpunkt
Sisting	Sisting
Ehmke	Ehmke
Gina	Gina
Komponenten	Komponente
BGB	BGB
festzusetzen	festsetzen
Handwerks	Handwerk
Erstellung	Erstellung
Lidl	Lidl
Hollmann	Hollmann
Veranlassung	Veranlassung
deren	d
Rohren	Rohr
Soltau	Soltau
Niedergörsdorf	Niedergörsdorf
Uhrbach	Uhrbach
Krampnitz	Krampnitz
Göttlin	Göttlin
Ausgabebetrags	Ausgabebetrags
Zeuthen	Zeuthen
Jorck	Jorck
HKF	HKF
Almelo	Almelo
Material	Material
Fredrich	Fredrich
Stadthagen	Stadthagen
Suhr	Suhr
Geschäftsordnung	Geschäftsordnung
Jagdhausstraße	Jagdhausstraße
Gesellschafterversammmlung	Gesellschafterversammmlung
können	können
W.B.	W.B.
Gummersbach	Gummersbach
diesbezügliche	diesbezüglich
Noppeney	Noppeney
sozialen	sozial
Bodo	Bodo
Lenhard	Lenhard
Sie	Sie
Gelegenheit	Gelegenheit
Appel	Appel
ABK	ABK
Koob	Koob
Blankenfelde	Blankenfeld
Polster	Polster
Wuthenow	Wuthenow
Lutz	Lutz
Dibowski	Dibowski
Burdekat	Burdekat
German	German
Benz	Benz
Ziesar	Ziesar
Gebieten	Gebieten
Mitwirkung	Mitwirkung
Knabe	Knabe
Meierei	Meierei
Bosak	Bosak
Luise	Luise
Secundär	Secundär
Gefrees	Gefrees
haftende	haftend
Neuendorf	Neuendorf
Wandlungsrechts	Wandlungsrechts
Halten	Halten
Schopf	Schopf
Struffert	Struffert
ausländischer	ausländisch
Lefering	Lefering
Sommer	Sommer
Plötzin	Plötzin
sich	sich
BAU	bauen
Freutel	Freutel
mbH	mbH
Ausschluß	Ausschluß
Über	über
Realisierungen	Realisierung
Kerpen	Kerpen
Kantsperger	Kantsperger
Abfällen	Abfällen
Norbert	Norbert
Zinna	Zinna
CM	cm
D.	D.
Igor	Igor
Information	Information
EAST	east
Baruth	Baruth
Olm	Olm
Containerdienst	Containerdienst
Paffhausen	Paffhausen
Absatzes	Absatz
dabei	dabei
Elke	Elke
Celeste	Celeste
Wirtschafts	Wirtschafts
N	N
Grundbuch	Grundbuch
Kommunikationstechnologie	Kommunikationstechnologie
Deutschen	deutsch
Geschäfts	Geschäft
Sprecher	Sprecher
Isdepski	Isdepski
Kretschmann	Kretschmann
Merseburg	Merseburg
Hansche	Hansche
Matthias	Matthias
Abfindung	Abfindung
Bung	Bung
Diagnoseverfahren	Diagnoseverfahren
Veräußerung	Veräußerung
Guendoul	Guendoul
Muske	Muske
Kirstein	Kirstein
Adler	Adler
Macheiner	Macheiner
Auftrage	Auftrag
Maler	Maler
stellvertretende	stellvertretend
Steffen	Steffen
le	le
gelegten	gelegt
Bio	Bio
Gebäudereinigung	Gebäudereinigung
Haberland	Haberland
Merten	Merten
Erkelenz	Erkelenz
Magerl	Magerl
Kündigung	Kündigung
Ergänzung	Ergänzung
bizzcomm	bizzcomm
Folgeeinrichtungen	Folgeeinrichtung
Bork	Bork
Einschluß	Einschluß
Inhaberaktien	Inhaberaktie
Tischler	Tischler
Schwertransporte	Schwertransport
Wanne	Wanne
Krane	Kran
selbstlos	selbstlos
Marie	Marie
Südhoff	Südhoff
Lindenbrück	Lindenbrück
bestellt	bestellen
Kockerols	Kockerols
Gebauer	Gebauer
solange	solange
elektrischen	elektrisch
Krönert	Krönert
Semar	Semar
Charles	Charles
Kapitalia	Kapitalia
beherrschter	beherrscht
Instandsetzung	Instandsetzung
Dietmar	Dietmar
Abgabenordnung	Abgabenordnung
Margret	Margret
Fertighäusern	Fertighaus
Hörschgen	Hörschgen
PROSEGUR	PROSEGUR
Bulk	Bulk
Natursteinarbeiten	Natursteinarbeiten
Aushub	Aushub
Rubner	Rubner
Fabian	Fabian
Ducree	Ducree
lauten	lauten
Zusammenarbeit	Zusammenarbeit
Kieswerke	Kieswerk
EKP	EKP
Einzelunternehmen	Einzelunternehmen
Pflege	Pflege
Software	Software
Bundesanzeigers	Bundesanzeigers
GesO	GesO
TH	TH
Klomp	Klomp
Großsterilisatoren	Großsterilisatoren
eingetragene	eingetragen
Lagebericht	Lagebericht
CBC	CBC
Immobilien	Immobilie
Wilkin	Wilkin
o.	oder
Anneliese	Anneliese
Bob	Bob
Engelmann	Engelmann
ARCADIS	ARCADIS
weiterer	weit
weiterhin	weiterhin
incl.	incl.
Kettwig	Kettwig
Wohnungseigentümergemeinschaften	Wohnungseigentümergemeinschaften
Speditions	Speditions
Auskünften	Auskunft
Gas	Gas
Kämeling	Kämeling
Fleisch	Fleisch
Vermeidung	Vermeidung
V.	V.
ändern	ändern
Viggo	Viggo
Mönchengladbach	Mönchengladbach
Polen	Polen
gehörende	gehörend
überwachungsbedürftiger	überwachungsbedürftig
Interessengemeinschaftsverträgen	Interessengemeinschaftsverträgen
Mietz	Mietz
Maurerarbeiten	Maurerarbeiten
Entsorgung	Entsorgung
Olympia	Olympia
Lesinska	Lesinska
Metallen	Metall
Vilbel	Vilbel
besonderer	besonder
gewerbliche	gewerblich
Alain	Alain
Brauer	Brauer
Baumanagement	Baumanagement
ht	ht
Pokorny	Pokorny
Vererbung	Vererbung
R.I.V.	R.I.V.
Zimpel	Zimpel
anmelden	anmelden
Gesellschaftsmitteln	Gesellschaftsmitteln
Security	Security
jetzt	jetzt
NAU	NAU
Börger	Börger
Kloster	Kloster
Meerbusch	Meerbusch
Neuzelle	Neuzelle
zudem	zudem
Aurachtal	Aurachtal
Beschlusses	Beschluß
geschlossen	schließen
aufgrund	aufgrund
beider	beide
Höft	Höft
DIALOG	Dialog
Ermäßigung	Ermäßigung
Genußrechte	Genußrechte
In	in
Der	d
Sendenhorst	Sendenhorst
Vertretung	Vertretung
erstmalig	erstmalig
einzelvertretungsberechtigt	einzelvertretungsberechtigt
ARCADIUM	ARCADIUM
Lüdinghausen	Lüdinghausen
Leipzig	Leipzig
Industriereinigung	Industriereinigung
Drogerie	Drogerie
Behälterbau	Behälterbau
Engineering	Engineering
Organen	Organ
Berufsbildungswerk	Berufsbildungswerk
Fragen	Fragen
Hochheim	Hochheim
Remiremont	Remiremont
eku	eku
Befugnis	Befugnis
Liefeld	Liefeld
Dauer	Dauer
Gebiet	Gebiet
Ohlhöft	Ohlhöft
Gladbach	Gladbach
Nowotny	Nowotny
melden	melden
Neubrandenburg	Neubrandenburg
Gewinnverwendung	Gewinnverwendung
Warmowski	Warmowski
Blut	Blut
Klapproth	Klapproth
Bruhn	Bruhn
Litzba	Litzba
Einzelrechtsnachfolge	Einzelrechtsnachfolge
Dufner	Dufner
Freiherr	Freiherr
Unternehmens	Unternehmen
Lohse	Lohse
private	privat
Dipl-Ing	Dipl-Ing
Bastaweisy	Bastaweisy
Böger	Böger
noch	noch
nicht	nicht
Kallinchen	Kallinchen
Cent	Cent
LKW	LKW
Thiemann	Thiemann
durchgeführt	durchführen
Woltersdorf	Woltersdorf
Sortieren	Sortieren
Ziegs	Ziegs
Weberstube	Weberstube
Kiebist	Kiebist
George	George
bestimmten	bestimmt
Ueckert	Ueckert
KARINA	KARINA
Jänicke	Jänicke
Glinde	Glinde
Fieland	Fieland
hinsichtlich	hinsichtlich
Verwalter	Verwalter
Grödel	Grödel
Pfullingen	Pfullingen
Krüger	Krüger
Letz	Letz
Augustdorf	Augustdorf
Potsdamer	Potsdamer
Großhandel	Großhandel
Ritter	Ritter
beteiligten	beteiligt
Aufgaben	Aufgabe
Baar	Baar
AWT	AWT
Fruchtspezialitäten	Fruchtspezialitäten
Farrokhnia	Farrokhnia
Rickert	Rickert
Wandlungs	Wandlungs
Benedikt	Benedikt
Formwechsel	Formwechsel
Taffert	Taffert
Schallau	Schallau
B.	B.
Hensellek	Hensellek
HILPERT	HILPERT
Weißenbach	Weißenbach
gewährleisten	gewährleisten
Eistert	Eistert
Immobilienverwaltung	Immobilienverwaltung
techn.	techn.
Biber	Biber
Tino	Tino
Runge	Runge
Abtretung	Abtretung
Ziff.	Ziff.
Vertretervertrag	Vertretervertrag
Drs	Drs
Fertigung	Fertigung
verursachten	verursachen
Ilte	Ilte
Darlehen	Darlehen
Tod	Tod
Hundenborn	Hundenborn
Saalow	Saalow
Habermann	Habermann
Pitzen	Pitzen
belegenen	belegenen
Baustoffhandel	Baustoffhandel
Marczak	Marczak
Beherrschungsvertrag	Beherrschungsvertrag
Kapitalgesellschaften	Kapitalgesellschaft
Carozzo	Carozzo
Betrag	Betrag
Bürotechnik	Bürotechnik
Burgwedel	Burgwedel
Logistik	Logistik
Entwicklungsgesellschaft	Entwicklungsgesellschaft
Pflegeeinrichtungen	Pflegeeinrichtung
Außenanlagen	Außenanlage
abschließen	abschließen
biotechnologischen	biotechnologisch
Europa	Europa
Erste	Erste
Gürtler	Gürtler
Aufsichtsratsmitglied	Aufsichtsratsmitglied
Pätz	Pätz
Mazer	Mazer
eingtetragen	eingtetragen
Westermann	Westermann
Körth	Körth
eigener	eigen
Valentin	Valentin
Isa	Isa
Artikel	Artikel
franke	frank
Jörg	Jörg
Lande	Land
Gow	Gow
A10	A10
Wohnorte	Wohnort
Ingenieurleistung	Ingenieurleistung
verwaltet	verwalten
Belzig	Belzig
Christian	Christian
geänderten	geändert
Gustav	Gustav
Generalunternehmer	Generalunternehmer
landwirtschaftlicher	landwirtschaftlich
Gehwegen	Gehweg
Täniges	Täniges
Zeestow	Zeestow
Jacobsen	Jacobsen
Soden	Soden
Sand	Sand
Dreßler	Dreßler
Demontage	Demontage
Dienstleistungsgesellschaft	Dienstleistungsgesellschaft
Udo	Udo
Haniel	Haniel
Kantinenservice	Kantinenservice
Wimmers	Wimmers
Rohrbeck	Rohrbeck
EuroStahl	EuroStahl
Calden	Calden
Krühler	Krühler
Betrieben	Betrieb
berechtigen	berechtigen
erfolgt	erfolgen
Koppe	Koppe
American	American
qualifizierte	qualifiziert
Wasserversorger	Wasserversorger
Berthe	Berthe
Wärmetechnik	Wärmetechnik
Verhältnis	Verhältnis
Angerstein	Angerstein
Vermögenswerte	Vermögenswert
Hertzstraße	Hertzstraße
Rückleben	Rückleben
Schrade	Schrade
Hausmeisterdienste	Hausmeisterdienst
Vermietung	Vermietung
Rechtsanwalt	Rechtsanwalt
Sigrid	Sigrid
VERTRIEBSKOORDINATION	VERTRIEBSKOORDINATION
zehn	zehn
See	See
Wolf	Wolf
Dow	Dow
Funck	Funck
Insolvenzverwalters	Insolvenzverwalters
Abfallentsorgungsanlagen	Abfallentsorgungsanlage
Doß	Doß
ihren	ihr
Nord	Nord
Wertz	Wertz
Umwandlungsgesetz	Umwandlungsgesetz
Vladeslav	Vladeslav
Höpner	Höpner
Wetzlar	Wetzlar
Elsholz	Elsholz
Montagearbeiten	Montagearbeiten
Kelkheim	Kelkheim
Ploderer	Ploderer
Handelsgeschäftes	Handelsgeschäftes
Dabei	dabei
Wachs	Wachs
Katarzyna	Katarzyna
Dänemark	Dänemark
DGAL	DGAL
Rotter	Rotter
Stendal	Stendal
Tage	Tag
Ansgar	Ansgar
Gericke	Gericke
Tecklenburg	Tecklenburg
UmwG	UmwG
Ramona	Ramona
Pflegearbeiten	Pflegearbeiten
ausführender	ausführend
Hannover	Hannover
Stiller	Stille
Gentgen	Gentgen
Wittich	Wittich
Tätigkeit	Tätigkeit
Langner	Langner
Stickel	Stickel
Jünemann	Jünemann
Genehmigtes	Genehmigte
Handelsvertretungen	Handelsvertretung
Beyer	Beyer
Linie	Linie
Stahnsdorf	Stahnsdorf
Design	Design
Beträge	Betrag
Kernbach	Kernbach
Wandlung	Wandlung
unterhält	unterhalten
Umwanldung	Umwanldung
Melzheimer	Melzheimer
Jeglitza	Jeglitza
Palenker	Palenker
Weiterentwicklung	Weiterentwicklung
Kubik	Kubik
Gebäude	Gebäude
Sandreinigung	Sandreinigung
Steffel	Steffel
vorliegenden	vorliegend
Vaswani	Vaswani
Euromedien	Euromedium
erbringen	erbringen
Avray	Avray
Zinssatz	Zinssatz
Kirsten	Kirsten
Kunststoffmachinen	Kunststoffmachinen
Friedel	Friedel
Produkten	Produkt
raumbildende	raumbildend
Rebholz	Rebholz
Ammersee	Ammersee
angefügt	anfügen
GNEISE	GNEISE
Kletke	Kletke
eröffnet	eröffnen
Nennwert	Nennwert
Belitz	Belitz
Huff	Huff
Di	Di
Fortsetzung	Fortsetzung
typisch	typisch
Harmening	Harmening
Königsbüscher	Königsbüscher
alsdann	alsdann
Sieg	Sieg
molekularer	molekularer
Wünsdorf	Wünsdorf
an	an
Kling	klingen
L	L
Anwendung	Anwendung
Bauke	Bauke
Niering	Niering
untitulierten	untitulierten
Sofern	sofern
Naues	Naues
Elert	Elert
Louis	Louis
Coquard	Coquard
Latacz	Latacz
Fertigparkettarbeiten	Fertigparkettarbeiten
Herr	Herr
Hennig	Hennig
Hermann	Hermann
van	van
Betrieb	Betrieb
Messeaktionen	Messeaktionen
Hoika	Hoika
trm	trm
Launer	Launer
derselben	derselben
Hof	Hof
GREBNER	GREBNER
Satzungsänderungen	Satzungsänderung
Basis	Basis
DaimlerChrysler	DaimlerChrysler
verschmolzen	verschmelzen
Ackermann	Ackermann
Amrhein	Amrhein
Marianne	Marianne
Thoms	Thoms
Kraatz	Kraatz
ggf.	ggf.
Zusatz	Zusatz
Immobiliengesellschaften	Immobiliengesellschaft
Vermögensteile	Vermögensteile
e.Kfr	e.Kfr
Hollberg	Hollberg
Wittkowski	Wittkowski
Puls	Puls
Am	am
Molekülen	Molekül
Wertpapierbörse	Wertpapierbörse
Katrin	Katrin
Brumm	brummen
Ökoton	Ökoton
Teicher	Teicher
derr	derr
Engelbert	Engelbert
Heike	Heike
Nominalbetrags	Nominalbetrags
Kirsch	Kirsch
Rahmen	Rahmen
Wilma	Wilma
Umtausch	Umtausch
Buchen	Buchen
Rülzheim	Rülzheim
Teilschuldverschreibungen	Teilschuldverschreibung
Vermarkten	Vermarkten
Zustimmungsbeschlüsse	Zustimmungsbeschlüsse
Kreises	Kreis
beauftragter	beauftragt
Bezugsrecht	Bezugsrecht
Rauch	Rauch
Knaak	Knaak
Krenzin	Krenzin
Wansdorf	Wansdorf
Thorsten	Thorsten
Gesamtprokura	Gesamtprokura
Dorothea	Dorothea
Anteilscheinen	Anteilscheinen
Klonsdorf	Klonsdorf
Funke	Funke
Theo	Theo
Installationsboden	Installationsboden
Heimo	Heimo
Gesellschafterbeschluß	Gesellschafterbeschluß
Claudio	Claudio
fremden	fremd
gegen	gegen
Teilung	Teilung
Zinsen	Zins
Forschungsaufgaben	Forschungsaufgabe
Zinke	Zinke
unwiderruflich	unwiderruflich
Lieselotte	Lieselotte
Immobilientreuhand	Immobilientreuhand
Einsammeln	Einsammeln
Reipöler	Reipöler
Marzena	Marzena
Durchschnittskurses	Durchschnittskurses
Electronic	Electronic
Energieversorgung	Energieversorgung
Bärbel	Bärbel
Heiner	Heiner
Sport	Sport
Aspect	Aspect
Ingenieurleistungen	Ingenieurleistung
wird	werden
Lüftungsanlagen	Lüftungsanlage
Gewinnverteilung	Gewinnverteilung
Tschink	Tschink
Carolin	Carolin
Franz	Franz
Saphörster	Saphörster
Neuseddin	Neuseddin
Arbeitnehmerüberlassung	Arbeitnehmerüberlassung
IMMOBILIEN	Immobilie
Sacheinlagen	Sacheinlage
PARK	parken
Instrumentenreinigungen	Instrumentenreinigungen
mindestens	mindestens
Lensahn	Lensahn
Aufspaltung	Aufspaltung
Weseram	Weseram
Boost	Boost
Kopplin	Kopplin
Tinnermann	Tinnermann
Glienick	Glienick
Austellungen	Austellungen
Entsorgungsmöglichkeiten	Entsorgungsmöglichkeit
Investmentanteilen	Investmentanteilen
Obertaxer	Obertaxer
Blönsdorf	Blönsdorf
Henze	Henze
Fichtner	Fichtner
Kregel	Kregel
Hildebrandt	Hildebrandt
Clement	Clement
Eigentumsformen	Eigentumsformen
Ahrensdorf	Ahrensdorf
Haigerloch	Haigerloch
Minden	Minden
aleinvertretungsbefugnis	aleinvertretungsbefugnis
alle	alle
Glasreinigungen	Glasreinigungen
Marquart	Marquart
Dürselen	Dürselen
gilt	gelten
Bar	Bar
sein	sein
Reinländer	Reinländer
Dividendenzahlungen	Dividendenzahlung
Loock	Loock
geltenden	geltend
wohnhaft	wohnhaft
Tilmann	Tilmann
Heimbürge	Heimbürge
Vogt	Vogt
Vermessung	Vermessung
Leonhard	Leonhard
Strüver	Strüver
Spielplatz	Spielplatz
Eigentumswohnungen	Eigentumswohnung
abberufen	abberufen
Werner	Werner
Schaffung	Schaffung
Einzelprokuren	Einzelprokuren
GEWE	GEWE
Aufträgen	Auftrag
Dachdeckerhandwerk	Dachdeckerhandwerk
Insolvenzverwalter	Insolvenzverwalter
Keil	Keil
Breest	Breest
Glock	Glock
Wuppertal	Wuppertal
Schneider	Schneider
Organisation	Organisation
Fernverkehr	Fernverkehr
Eigentum	Eigentum
Bezüglich	bezüglich
Personalberatung	Personalberatung
Rother	Rother
Dubberstein	Dubberstein
Henschel	Henschel
Börsennotierung	Börsennotierung
Steinkopf	Steinkopf
zusammenhang	Zusammenhang
AO	AO
Zi.	Zi.
Gerson	Gerson
SHM	SHM
Nowak	Nowak
Stellmacher	Stellmacher
Göricke	Göricke
Einzelvertretungsbefugnis	Einzelvertretungsbefugnis
Einzelprokuristinnen	Einzelprokuristinnen
Brümmerstädt	Brümmerstädt
führen	führen
Textilreinigungsgewerbe	Textilreinigungsgewerbe
Schade	schade
Lüneburg	Lüneburg
Harvinder	Harvinder
Umsetzung	Umsetzung
Achtelik	Achtelik
HOCHTIEF	Hochtief
UmwBerG	UmwBerG
Kähnsdorf	Kähnsdorf
Grünanlagen	Grünanlage
Berlin	Berlin
Reget	Reget
Hochbauten	Hochbau
Aktien	Aktie
Betrages	Betrag
je	je
Versmold	Versmold
Holzbrücken	Holzbrücke
N.	N.
Berthold	Berthold
Felske	Felske
Susann	Susann
Einzelprokura	Einzelprokura
Dreieich	Dreieich
Hofgeismar	Hofgeismar
Davids	Davids
Prokuristin	Prokuristin
Tröbsdorf	Tröbsdorf
Ingenieurbauwerke	Ingenieurbauwerke
Julia	Julia
mittelbaren	mittelbar
August	August
Abfertigungsspedition	Abfertigungsspedition
Vorschriften	Vorschrift
Zur	zur
Mitgliedern	Mitglied
ARDO	ARDO
Bereichen	Bereich
Tünschel	Tünschel
übertragenden	übertragend
Donat	Donat
Riese	Riese
Baumaßnahmen	Baumaßnahme
Bundesanzeiger	Bundesanzeiger
Catering	Catering
Schulfachverlag	Schulfachverlag
Gesellschafterausschuß	Gesellschafterausschuß
BWG	BWG
Auf	auf
BÄR	Bär
Laskowski	Laskowski
Facility	Facility
Halb	halb
Stellung	Stellung
Bürofachfarkt	Bürofachfarkt
Wittstruck	Wittstruck
Firmenbestandteilen	Firmenbestandteilen
Gottfried	Gottfried
Schriftform	Schriftform
Deußer	Deußer
Division	Division
Konzern	Konzern
Tina	Tina
Kuhnt	Kuhnt
Wind	Wind
Birkenwerder	Birkenwerder
Garski	Garski
kaufmännische	kaufmännisch
Sabit	Sabit
Sosnowski	Sosnowski
Herstellung	Herstellung
Bettin	Bettin
Manuela	Manuela
Heinrich	Heinrich
Lucas	Lucas
Flugservice	Flugservice
Neustadt	Neustadt
Lipinski	Lipinski
Bajerski	Bajerski
Tief	Tief
Handwerksausbildung	Handwerksausbildung
Verpflichtung	Verpflichtung
neue	neu
Einvernehmen	Einvernehmen
Läden	Laden
Geschäftstätigkeiten	Geschäftstätigkeit
Falkenhagener	Falkenhagener
Dannebaum	Dannebaum
Multimedia	Multimedia
Lampe	Lampe
Spaltungsvertrages	Spaltungsvertrages
würde	werden
Nitsch	Nitsch
Lotz	Lotz
Goldberger	Goldberger
bedürfen	bedürfen
Mannesmann	Mannesmann
Vertriebs	Vertrieb
Nickel	Nickel
Odenthal	Odenthal
Meister	Meister
Kultur	Kultur
Justus	Justus
immobiliengleichen	immobiliengleichen
besser	gut
Nunmehr	nunmehr
Hilmar	Hilmar
Stahl	Stahl
Boynueyri	Boynueyri
Werbe	werben
Insovenzverfahrens	Insovenzverfahrens
Strategische	strategisch
Bauentwicklung	Bauentwicklung
ermäßigt	ermäßigen
Blatt	Blatt
Silvia	Silvia
Beherbergungsgewerbe	Beherbergungsgewerbe
Steiner	Steiner
Niels	Niels
Diesen	dies
Andrzey	Andrzey
Finanzierungsvermittlung	Finanzierungsvermittlung
bürgerlichen	bürgerlich
SONAR	SONAR
München	München
Frevert	Frevert
Stroetmann	Stroetmann
GMBH	GMBH
Verkauf	Verkauf
Straßen	Straße
Firmen	Firmen
Bockkran	Bockkran
Höhe	Höhe
Arnsberg	Arnsberg
Ablauf	Ablauf
Mietverträgen	Mietvertrag
künftig	künftig
Umwandlungsbereinigungsgesetz	Umwandlungsbereinigungsgesetz
Schmoll	schmollen
Neuer	neu
Souvenir	Souvenir
Klingenberg	Klingenberg
Dadurch	dadurch
planerischen	planerischen
Desselmann	Desselmann
Gesper	Gesper
vorberuflichen	vorberuflichen
Radeck	Radeck
Funk	Funk
Wertpapierhandel	Wertpapierhandel
Harry	Harry
Grosser	Grosser
ihre	ihr
Höhn	höhnen
Langerwisch	Langerwisch
Gasrohrbau	Gasrohrbau
Saskia	Saskia
bisher	bisher
Schoemaker	Schoemaker
Hugo	Hugo
werden	werden
Detlef	Detlef
Linke	Linke
Kontierung	Kontierung
Beuster	Beuster
ermächtigen	ermächtigen
Wolters	Wolters
Finsterwalder	Finsterwalder
Stahlkonstruktionen	Stahlkonstruktion
Teppichböden	Teppichböden
Abfallbesitzern	Abfallbesitzern
erfordern	erfordern
Stammkapitals	Stammkapital
Giese	Giese
Häusern	Haus
Dirk	Dirk
Zuzahlungen	Zuzahlung
Beruf	Beruf
Mansour	Mansour
Bornstedt	Bornstedt
Kunst	Kunst
Auswahl	Auswahl
BüroRaumkonzeption	BüroRaumkonzeption
Altmark	Altmark
begebenden	begebenden
Niemegk	Niemegk
gemäß	gemäß
Befestigung	Befestigung
Kommanditgesellschaft	Kommanditgesellschaft
ATR	ATR
L.	L.
Hohen	Hohe
eröffnenden	eröffnend
Kläffling	Kläffling
Schoft	Schoft
Grzegorzewski	Grzegorzewski
Betreiben	Betreiben
Aßmann	Aßmann
Flensburg	Flensburg
Platen	Platen
Anpassungsprozesse	Anpassungsprozeß
Spree	Spree
durchführen	durchführen
Management	Management
Industrieanlagenreinigung	Industrieanlagenreinigung
Elsterstraße	Elsterstraße
Beschaffung	Beschaffung
Kaatz	Kaatz
Sutter	Sutter
Van	Van
nützlich	nützlich
erlangen	erlangen
Reinigung	Reinigung
Ferchesar	Ferchesar
namentlich	namentlich
Saltsjö	Saltsjö
Milow	Milow
Kabel	Kabel
Landwirtschaftsprodukten	Landwirtschaftsprodukt
Berechnung	Berechnung
Suche	Suche
Simon	Simon
mieten	mieten
Hahn	Hahn
Wettbewerb	Wettbewerb
VR	VR
Zweigniederlassungen	Zweigniederlassung
Luppenau	Luppenau
Lauf	Lauf
Gundel	Gundel
Swinne	Swinne
Hönow	Hönow
Rainer	Rainer
beruflichen	beruflich
Dornfeld	Dornfeld
Stufe	Stufe
Hoch	Hoch
Helmuth	Helmuth
Rocky	Rocky
Sitz	Sitz
Bleul	Bleul
Kriftel	Kriftel
Hohenberg	Hohenberg
Vorläufiger	vorläufig
Lohnbuchhaltung	Lohnbuchhaltung
Bereinigungen	Bereinigung
Mevlüt	Mevlüt
Primus	Primus
Franco	Franco
Mainz	Mainz
FEELINI	FEELINI
Bearbeitung	Bearbeitung
Hagen	Hagen
Uetze	Uetze
DIABOS	DIABOS
verwerten	verwerten
wie	wie
die	d
binnen	binnen
Czenkusch	Czenkusch
Robert	Robert
Rico	Rico
Geschäften	Geschäft
nutzen	nutzen
Gebrauch	Gebrauch
Neuendorff	Neuendorff
Initiierung	Initiierung
Fortschritt	Fortschritt
strukturpolitisches	strukturpolitisch
Seminaren	Seminar
Schilling	Schilling
Hauptversammlungsbeschluss	Hauptversammlungsbeschluss
Prototypen	Prototyp
Teilbeträgen	Teilbetrag
tbg	tbg
Handelsregister	Handelsregister
Niebel	Niebel
Brink	Brink
Beier	Beier
Bühler	Bühler
Merkert	Merkert
Tankschutztechnik	Tankschutztechnik
Kollark	Kollark
Zeitpunkt	Zeitpunkt
Eichholzer	Eichholzer
Nagora	Nagora
Grundpfandrechte	Grundpfandrechte
damit	damit
Steinmüller	Steinmüller
zwingenden	zwingend
Bert	Bert
Röhl	Röhl
Aufsichtsratsvergütung	Aufsichtsratsvergütung
geb.	Geb.
Verwaltungsgesellschaft	Verwaltungsgesellschaft
ihr	ihr
Metallbau	Metallbau
Hilter	Hilter
Wieske	Wieske
Stammer	Stammer
Industrieunternehmen	Industrieunternehmen
Kampowski	Kampowski
Dieckmann	Dieckmann
ähnlicher	ähnlich
Hänelt	Hänelt
Krautz	Krautz
Lorenz	Lorenz
Mernberger	Mernberger
Hanf	Hanf
Friederike	Friederike
Handelsgesellschaften	Handelsgesellschaft
Genehmigung	Genehmigung
vorgesehen	vorsehen
Produktentwicklung	Produktentwicklung
Beratungsunternehmens	Beratungsunternehmen
unterstützt	unterstützen
Beschlussfassung	Beschlussfassung
Gierit	Gierit
steht	stehen
Datennetzen	Datennetz
Computereinrichtungen	Computereinrichtungen
Schönfließ	Schönfließ
7a	7a
Gesellschafterversammlung	Gesellschafterversammlung
Erfolge	Erfolg
verwalten	verwalten
Landschaftsplanerische	Landschaftsplanerische
Existenzsicherung	Existenzsicherung
Einzelprokurist	Einzelprokurist
Diekmann	Diekmann
logistische	logistisch
Blecherzeugnisse	Blecherzeugnisse
Lüftungstechnik	Lüftungstechnik
Textilpflege	Textilpflege
Aktionäre	Aktionär
hiermit	hiermit
Kaczinski	Kaczinski
Koedijk	Koedijk
Beteiligungen	Beteiligung
Pflichtaufgaben	Pflichtaufgabe
eingetrage	eingetrage
Eyberg	Eyberg
Diskotheken	Diskothek
Fortbildung	Fortbildung
Board	Board
Frachtvermittlung	Frachtvermittlung
Rudi	Rudi
Liquidator	Liquidator
Goering	Goering
Research	Research
Thusbaß	Thusbaß
Preßler	Preßler
Godesberg	Godesberg
Ansiedlungsentwicklung	Ansiedlungsentwicklung
Gundula	Gundula
Derk	Derk
San	San
Sieker	Sieker
Thiede	Thiede
Erdungs	Erdungs
Roch	riechen
Régnier	Régnier
Präsidialausschuß	Präsidialausschuß
Weiß	Weiß
Gregor	Gregor
Unternehmensgegenstand	Unternehmensgegenstand
soweit	soweit
d.h.	d.h.
Zmavc	Zmavc
Hardware	Hardware
Hoidis	Hoidis
Maisel	Maisel
elektrische	elektrisch
Viktor	Viktor
Frowein	Frowein
Soyka	Soyka
Mail	Mail
Bauträger	Bauträger
Rothenfelde	Rothenfelde
Havelländische	Havelländische
Sabine	Sabine
Biosynthese	Biosynthese
EG	EG
Dies	dies
Barthel	Barthel
Duchow	Duchow
Werthmann	Werthmann
entsorgung	Entsorgung
Schultze	Schultze
I	I
Unterlagen	Unterlage
An	an
Heitzmann	Heitzmann
Bendler	Bendler
Tinseau	Tinseau
eigenwirtschaftliche	eigenwirtschaftlich
glaubhaft	glaubhaft
sechs	sechs
Mobilfunk	Mobilfunk
Paket	Paket
Stahlbaum	Stahlbaum
Mediacast	Mediacast
Hohlmeier	Hohlmeier
Rohr	Rohr
print	print
Real	real
Straube	Straube
Vogel	Vogel
Schroeder	Schroeder
Holdings	Holding
Transport	Transport
Schenefeld	Schenefeld
Almsick	Almsick
Rohrmann	Rohrmann
zustehenden	zustehend
Bühring	Bühring
bebauen	bebauen
Lanitz	Lanitz
Kulle	Kulle
Gesamtnennbetrag	Gesamtnennbetrag
Wert	Wert
Z	Z
Hillebrand	Hillebrand
Rodeike	Rodeike
Beschränkungen	Beschränkung
Seiger	Seiger
Silva	Silva
Helin	Helin
liegt	liegen
Möglichkeiten	Möglichkeit
Ken	Ken
Lemke	Lemke
Transportversicherungen	Transportversicherung
Einheitskurse	Einheitskurse
Erasmus	Erasmus
Nicki	Nicki
Oberhausen	Oberhausen
Schwensen	Schwensen
Kotlowski	Kotlowski
Hausbau	Hausbau
Fondsbeteiligungen	Fondsbeteiligungen
Hantke	Hantke
Raumzellen	Raumzellen
Geschäftsfeldern	Geschäftsfeld
Gabriel	Gabriel
Bauvorhaben	Bauvorhaben
Quirnheim	Quirnheim
Betreutes	Betreute
Im	im
Hanau	Hanau
Hofmann	Hofmann
Dienstleistungsbereiche	Dienstleistungsbereich
frei	frei
Hardwarekomponenten	Hardwarekomponenten
Lünen	Lünen
Staub	Staub
Botho	Botho
Firma	Firma
Maiwald	Maiwald
Aufträge	Auftrag
Roger	Roger
Kubacki	Kubacki
Beteiligung	Beteiligung
Wasser	Wasser
Schwerin	Schwerin
mehrere	mehrere
beanspruchen	beanspruchen
u.	um
Rettler	Rettler
Dedelstorf	Dedelstorf
Ismail	Ismail
Schulte	Schulte
dazu	dazu
TVM	TVM
Jahresüberschuss	Jahresüberschuss
Etienne	Etienne
Freytag	Freytag
Hansjörg	Hansjörg
Gitta	Gitta
Dzwonnek	Dzwonnek
Adolf	Adolf
Prüflabors	Prüflabors
Wolfram	Wolfram
Tangens	Tangens
Apel	Apel
geschäftsführende	geschäftsführend
Matthäi	Matthäi
Reimann	Reimann
Gebhard	Gebhard
Päwesin	Päwesin
Isernhagen	Isernhagen
Wernsdorf	Wernsdorf
selbständigen	selbständig
Haberstroh	Haberstroh
Zeit	Zeit
Wirtschaftskauffrau	Wirtschaftskauffrau
wesentlichen	wesentlich
Führer	Führer
Bruns	Bruns
Parthey	Parthey
erhöhte	erhöht
Brombach	Brombach
traditioneller	traditionell
Fall	Fall
alleinvertetungsberechtigt	alleinvertetungsberechtigt
verdoppelt	verdoppeln
bereits	bereits
aufgehoben	aufheben
Starnberg	Starnberg
Luft	Luft
Gerianta	Gerianta
jede	jed
Beachtung	Beachtung
Als	als
Theilemann	Theilemann
Ulrich	Ulrich
Preuß	Preuß
Bredereck	Bredereck
Barnim	Barnim
Kaufverträgen	Kaufvertrag
haftender	haftend
Erich	Erich
ersten	erst
Seibel	Seibel
Elektromeister	Elektromeister
Gewerbe	Gewerbe
Stadtbuchhandlung	Stadtbuchhandlung
Anton	Anton
Projekten	Projekt
Monats	Monat
Ablehnung	Ablehnung
Maren	Maren
Kontor	Kontor
Neubert	Neubert
Woersdorf	Woersdorf
jeder	jed
Gütern	Gut
Eichholz	Eichholz
Siegert	Siegert
Ludwig	Ludwig
Nutzungsberechtigten	Nutzungsberechtigte
Korobkow	Korobkow
Gensler	Gensler
Gerd	Gerd
Gebäudereinigungen	Gebäudereinigungen
Fahrland	Fahrland
Pabst	Pabst
Schlemmer	Schlemmer
übertragenen	übertragen
Lehnin	Lehnin
Fohrde	Fohrde
Aufbereiten	Aufbereiten
Staudinger	Staudinger
herrschendem	herrschendem
außerdem	außerdem
Sammeln	Sammeln
Beeker	Beeker
Bestellung	Bestellung
Rohrschneider	Rohrschneider
Hempel	Hempel
Reuß	Reuß
Conrad	Conrad
Beesten	Beesten
Potsdam	Potsdam
Medientechnologien	Medientechnologie
Hooke	Hooke
Krupp	Krupp
Topp	Topp
Grosner	Grosner
Bornemann	Bornemann
Jesko	Jesko
entstandene	entstanden
Kursawe	Kursawe
Mosbach	Mosbach
verbrieften	verbrieften
Capellen	Capellen
Analysen	Analyse
daß	daß
Jahren	Jahr
unter	unter
Geschäftsführerbefugnis	Geschäftsführerbefugnis
Ermittlungen	Ermittlung
Gesamtvollstreckungsvefahrens	Gesamtvollstreckungsvefahrens
Geisenheim	Geisenheim
Saale	Saale
Mietzner	Mietzner
Klärwerkes	Klärwerk
IDAS	IDAS
Bucher	Bucher
Ferley	Ferley
Gnewikow	Gnewikow
Tischen	Tischen
Ausnahme	Ausnahme
Außerdem	außerdem
Lacher	Lacher
Befördern	Befördern
Königs	Königs
Anger	Anger
Förderungsmaßnahmen	Förderungsmaßnahme
Ramien	Ramien
Weiland	weiland
Ausbauten	Ausbau
entgültigen	entgültigen
Merzenich	Merzenich
Hamilton	Hamilton
überbetrieblichen	überbetrieblich
Anette	Anette
Claudia	Claudia
Bartash	Bartash
Confair	Confair
Konradsreuth	Konradsreuth
Weitere	weit
Treuchtlingen	Treuchtlingen
Simmen	Simmen
Malterhausen	Malterhausen
biotechnoligischen	biotechnoligischen
Siebert	Siebert
Rehhagen	Rehhagen
aufgelaufener	aufgelaufener
Partnership	Partnership
Manig	Manig
vermitteln	vermitteln
Laubenstein	Laubenstein
Baeck	Baeck
Karl	Karl
Reparaturarbeiten	Reparaturarbeiten
Betonbohr	Betonbohr
Schraven	Schraven
Baubetreuer	Baubetreuer
Scholten	Scholten
der	d
Gesamtprodura	Gesamtprodura
Heermann	Heermann
Christensen	Christensen
Reetz	Reetz
Sander	Sander
Spezialfutter	Spezialfutter
Rött	Rött
Finish	Finish
Beglari	Beglari
Jürgens	Jürgens
Kießling	Kießling
Leo	Leo
Forschung	Forschung
öffentlichen	öffentlich
Renate	Renate
darf	dürfen
Alle	alle
Jörn	Jörn
Neustückelung	Neustückelung
Pielot	Pielot
Schilde	Schild
Ausschachtungs	Ausschachtungs
Er	er
zugestimmt	zustimmen
Sozialdienstes	Sozialdienst
Hildegard	Hildegard
Riesen	Riese
Kristof	Kristof
Wilhelmshorst	Wilhelmshorst
Pofahl	Pofahl
dieses	dies
Ikenmeyer	Ikenmeyer
Geschäftsjahr	Geschäftsjahr
Astrid	Astrid
Brieselang	Brieselang
Neuland	Neuland
Einführung	Einführung
Erhaltung	Erhaltung
e.dis	e.dis
Jesewitz	Jesewitz
Baldham	Baldham
Steuerberater	Steuerberater
Heizungs	Heizungs
gemeinsam	gemeinsam
Vechta	Vechta
Niederlassung	Niederlassung
dafür	dafür
Rolack	Rolack
Bergisch	bergisch
Gutsche	Gutsche
Auto	Auto
Egloffstein	Egloffstein
a.	a.
wirksam	wirksam
MTU	MTU
Kai	Kai
Handwerkerrolle	Handwerkerrolle
Barz	Barz
Eisengarten	Eisengarten
Schoiber	Schoiber
Liquidatoren	Liquidator
Helma	Helma
Braun	Braun
Herne	Herne
prozentuale	prozentual
Hansen	Hansen
Froböse	Froböse
Sohn	Sohn
beim	beim
Aufsichtsrat	Aufsichtsrat
Betreuung	Betreuung
Brinker	Brinker
Applied	Applied
Executive	Executive
Vermarktung	Vermarktung
Neuenstein	Neuenstein
gleiche	gleich
Horstmann	Horstmann
fördern	fördern
Probeentnahmen	Probeentnahme
Braunschweig	Braunschweig
Laube	Laube
Meier	Meier
begründet	begründen
Berg	Berg
Luigi	Luigi
Optionsschuldverschreibungen	Optionsschuldverschreibung
Gronau	Gronau
Petsch	Petsch
Film	Film
Klima	Klima
Bokholt	Bokholt
Zuweisung	Zuweisung
Nauen	Nauen
Hochgrebe	Hochgrebe
Verlagsgesellschaft	Verlagsgesellschaft
Stammkaptial	Stammkaptial
Czakert	Czakert
Carron	Carron
Schener	Schener
Lippstadt	Lippstadt
Einzelhandel	Einzelhandel
Radwer	Radwer
Maritta	Maritta
Geschäftsführungsgesellschaft	Geschäftsführungsgesellschaft
systemen	System
Unkenholt	Unkenholt
Ullrich	Ullrich
Sperrfrist	Sperrfrist
ABB	ABB
befindlichen	befindlich
Devermann	Devermann
Bayerl	Bayerl
Sanitärarbeiten	Sanitärarbeiten
Wedel	Wedel
Lüftungs	Lüftungs
Pansy	Pansy
Gewinnabführungs	Gewinnabführungs
Dentalausrüstungen	Dentalausrüstungen
Reiffel	Reiffel
Straßburger	Straßburger
Reblé	Reblé
Großenheidorn	Großenheidorn
Schachschal	Schachschal
zählen	zählen
Gräbendorf	Gräbendorf
übernehmenden	übernehmend
Gesellschaftersbeschluss	Gesellschaftersbeschluss
ALEX	ALEX
Bindung	Bindung
Großhansdorf	Großhansdorf
Wiggert	Wiggert
ihnen	sie
StbG	StbG
Angelika	Angelika
Albrecht	Albrecht
Post	Post
Wandels	Wandel
Christoph	Christoph
ab	ab
Wettstein	Wettstein
Erika	Erika
Weckener	Weckener
Landschaftsbau	Landschaftsbau
gestrichen	streichen
ausgebüt	ausgebüt
Main	Main
Bernhard	Bernhard
Schedler	Schedler
Ernicke	Ernicke
Wiedenmann	Wiedenmann
G	G
hat	haben
Aktionär	Aktionär
Martino	Martino
Mayer	Mayer
Emil	Emil
Barbara	Barbara
Kowalenko	Kowalenko
Gesellschaftsvertrag	Gesellschaftsvertrag
gezeichnet	zeichnen
Optionsrechte	Optionsrechte
Detektei	Detektei
Vorsitzender	Vorsitzende
Gesellschaftsvertrages	Gesellschaftsvertrag
Todesfall	Todesfall
Zeh	Zeh
gehört	gehören
Gebäuden	Gebäude
bestehenden	bestehend
Stark	Stark
Mario	Mario
Kostic	Kostic
Ildikó	Ildikó
Kornmesser	Kornmesser
Mattis	Mattis
HSL	HSL
Aktiengesetz	Aktiengesetz
Barra	Barra
Bertz	Bertz
Mönster	Mönster
Flächen	Fläche
sonstigen	sonstig
Baumaschinenservice	Baumaschinenservice
Andre	Andre
Struveshofer	Struveshofer
Werterhaltung	Werterhaltung
Beratung	Beratung
Salvatorische	Salvatorische
Bautenschutzgewerbe	Bautenschutzgewerbe
Färber	Färber
Alleinvertretungsbefugnis	Alleinvertretungsbefugnis
Interesse	Interesse
Konstruktion	Konstruktion
Hamburg	Hamburg
Speditionskaufmann	Speditionskaufmann
Anpassungsprozessen	Anpassungsprozeß
Heuchelheim	Heuchelheim
tätig	tätig
Export	Export
selbst	selbst
Ingenieur	Ingenieur
Aupers	Aupers
Engels	Engels
Mund	Mund
Zweck	Zweck
Messe	Messe
Verbreitung	Verbreitung
Senden	Senden
Molekülkomplexen	Molekülkomplexen
PWS	PWS
Alt	Alt
Allwardt	Allwardt
Velten	Velten
Nennbetrag	Nennbetrag
Strausberg	Strausberg
kommunale	kommunal
Abfallentsorgungsunternehmen	Abfallentsorgungsunternehmen
mehreren	mehrere
Chambers	Chambers
Faller	Faller
Edeltraud	Edeltraud
Nominalbetrag	Nominalbetrag
Lindert	lindern
Sperenberg	Sperenberg
Whitney	Whitney
Mittag	Mittag
zwingendes	zwingend
Ibbenbüren	Ibbenbüren
Pätzold	Pätzold
ela	ela
Reiche	Reiche
Schulungsmaßnahmen	Schulungsmaßnahme
RAG	RAG
Lupp	Lupp
Harynek	Harynek
Hoppenrath	Hoppenrath
Idstein	Idstein
stehen	stehen
Joseph	Joseph
Point	Point
voller	voll
Briest	Briest
Zugang	Zugang
Gesellschaftern	Gesellschafter
maßgeblich	maßgeblich
Slubice	Slubice
Maurermeister	Maurermeister
geteilten	geteilt
Ansiedlung	Ansiedlung
eintreten	eintreten
Beginn	Beginn
Von	von
Mahler	Mahler
Jeder	jed
Public	Public
Kapitalherabsetzung	Kapitalherabsetzung
Kautschor	Kautschor
künftigen	künftig
Luckenwalde	Luckenwalde
Einheitskurs	Einheitskurs
Ralf	Ralf
Services	Service
Hubert	Hubert
Darüber	darüber
Zierl	Zierl
Kapitals	Kapital
verlagsgesellschaft	Verlagsgesellschaft
Strukturen	Struktur
Liquidators	Liquidator
unbeschränkte	unbeschränkt
Düren	Düren
Wulff	Wulff
Mathäa	Mathäa
zustimmenden	zustimmend
Sach	Sach
Recklinghausen	Recklinghausen
Überprüfung	Überprüfung
Checkpoint	Checkpoint
Durch	durch
Vermietungs	Vermietungs
beliebigen	beliebig
Breman	Breman
nur	nur
jeweiligen	jeweilig
HRB	HRB
Carpin	Carpin
Vergütung	Vergütung
Bauleitung	Bauleitung
Zastawny	Zastawny
Schwarzkopf	Schwarzkopf
Windkraft	Windkraft
Fälle	Fall
Vollgewerbe	Vollgewerbe
Böhme	Böhme
Hertzsch	Hertzsch
Bauarbeiten	Bauarbeiten
Chance	Chance
laufenden	laufend
Grundbesitzverwertung	Grundbesitzverwertung
formwechselnden	formwechselnden
Gewerken	Gewerken
Brunhilde	Brunhilde
Diekert	Diekert
Hinrich	Hinrich
Hecht	Hecht
bedingte	bedingt
Schlußwert	Schlußwert
Venture	Venture
Außen	Außen
verbundene	verbunden
Krawielitzki	Krawielitzki
Hartz	Hartz
MEDIZINTECHNIK	Medizintechnik
Jens	Jens
Aslan	Aslan
Spezialtransporte	Spezialtransport
Nuthe	Nuthe
Iwanowitsch	Iwanowitsch
Erhöhung	Erhöhung
außereuropäischen	außereuropäisch
Wirtschaftlichkeit	Wirtschaftlichkeit
Hausmeisterei	Hausmeisterei
Miltenberg	Miltenberg
ergebende	ergebend
grad.	grad.
Geschäftsführung	Geschäftsführung
Kabelkonfektionierung	Kabelkonfektionierung
Willfried	Willfried
Tietzow	Tietzow
Hanns	Hanns
Yogeshlal	Yogeshlal
Wohnungen	Wohnung
Veranstaltungen	Veranstaltung
Senger	Senger
Restaurant	Restaurant
Verarbeitung	Verarbeitung
Unternehmungen	Unternehmung
rechnerischen	rechnerisch
Bernd	Bernd
Rothenburg	Rothenburg
Kapitale	Kapitale
Erschließungsarbeiten	Erschließungsarbeiten
Rechtsanwältin	Rechtsanwältin
Bioinformatik	Bioinformatik
Tapeten	Tapete
Siegmund	Siegmund
Gries	Gries
Hentrei	Hentrei
Place	Place
Büroservice	Büroservice
Bürobedarf	Bürobedarf
Bosse	Boß
GewO	GewO
Poppe	poppen
Nach	nach
Helga	Helga
Roesler	Roesler
Anwender	Anwender
Töpchin	Töpchin
Wandlungspreis	Wandlungspreis
Vertretungsbefugnis	Vertretungsbefugnis
Spivak	Spivak
Mischker	Mischker
entsprechen	entsprechen
Fischer	Fischer
einzeln	einzeln
Marcinkowski	Marcinkowski
T.	T.
Produktion	Produktion
Kompostierungsanlage	Kompostierungsanlage
ähnlichen	ähnlich
ersatzlos	ersatzlos
Vorstandsvorsitzender	Vorstandsvorsitzende
Francois	Francois
Engelke	Engelke
Search	Search
demselben	demselben
Rohrleitungsbau	Rohrleitungsbau
Kutschera	Kutschera
Niederlande	Niederlande
Geiseler	Geiseler
Gnadl	Gnadl
Schupp	Schupp
Kipp	kippen
Steinert	Steinert
Radeburg	Radeburg
Mühlheim	Mühlheim
Ermächtigungen	Ermächtigung
aufgelöst	auflösen
Abnahme	Abnahme
Westerstede	Westerstede
Kommunikationssystemen	Kommunikationssystem
Kemppel	Kemppel
vergleichbaren	vergleichbar
Druckgesellschaft	Druckgesellschaft
Mioc	Mioc
Erfurt	Erfurt
Kosten	Kosten
keine	kein
Entscheidung	Entscheidung
Niendorf	Niendorf
Raback	Raback
Ludwigsfelde	Ludwigsfelde
technologischen	technologisch
Babak	Babak
entsprechende	entsprechend
Tomala	Tomala
KZ	KZ
Offenbach	Offenbach
geändert	ändern
Multiplikation	Multiplikation
Fischerstraße	Fischerstraße
stehenden	stehend
Sitzbezeichnung	Sitzbezeichnung
in	in
Kupfernagel	Kupfernagel
Vorstands	Vorstand
Inbetriebnahme	Inbetriebnahme
Jahresabschluß	Jahresabschluß
Beteiligungsgesellschaft	Beteiligungsgesellschaft
Nehls	Nehls
Walters	Walters
Prozentsätzen	Prozentsätzen
g	g
Koblenz	Koblenz
AE	AE
Ruhr	Ruhr
Fiedler	Fiedler
Dokumentare	Dokumentare
Schübel	Schübel
Bundesrepublik	Bundesrepublik
Rechenburg	Rechenburg
Einweisungen	Einweisung
II	II
Clément	Clément
Natursteinfassaden	Natursteinfassade
Ytong	Ytong
Änderungen	Änderung
Für	für
bedingtes	bedingt
Rüstig	rüstig
Stück	Stück
Wald	Wald
hinaus	hinaus
Liquidatorin	Liquidatorin
Tertilt	Tertilt
Sven	Sven
bautechnischer	bautechnischer
Haußwald	Haußwald
Osnabrück	Osnabrück
Flack	Flack
Ecke	Ecke
Verträgen	Vertrag
Folgen	Folgen
Mutterkuhhaltung	Mutterkuhhaltung
Notgeschäftsführerin	Notgeschäftsführerin
einzelnen	einzeln
Gramer	Gramer
Winkelhaid	Winkelhaid
zwei	zwei
Landschaftsbaus	Landschaftsbaus
Abs.	Abs.
Schwedtke	Schwedtke
Egbringhoff	Egbringhoff
Karola	Karola
Volkmann	Volkmann
Brielow	Brielow
betrifft	betreffen
Werkschutz	Werkschutz
Ewald	Ewald
Bertram	Bertram
Bochow	Bochow
Wahlsdorf	Wahlsdorf
Führungskräften	Führungskraft
Gliesche	Gliesche
Kröhnert	Kröhnert
Johannisberg	Johannisberg
Gerth	Gerth
Schlüsselfunktionen	Schlüsselfunktion
gleichzeitig	gleichzeitig
Forum	Forum
Hessen	Hessen
Das	d
Hamdia	Hamdia
Schild	Schild
dies	dies
Roll	rollen
Prokuristen	Prokurist
genannten	genannt
Fuchs	Fuchs
KRIEG	kriegen
bisherigen	bisherig
Füchter	Füchter
ALBRO	ALBRO
Mühle	Mühle
Hotz	Hotz
darüber	darüber
Aktiengesellschaft	Aktiengesellschaft
Guthan	Guthan
Schwietering	Schwietering
Schuko	Schuko
Klenner	Klenner
Rechtsgeschäfe	Rechtsgeschäfe
Doreen	Doreen
Schemann	Schemann
Erprobung	Erprobung
Timm	Timm
Hunger	Hunger
Reiner	rein
Straßenbau	Straßenbau
Schmidts	Schmidts
Versicherungen	Versicherung
durch	durch
aufgelösten	aufgelöst
einem	ein
einzigen	einzig
vorläufigen	vorläufig
Bludovsky	Bludovsky
Werkschutzes	Werkschutz
Produkte	Produkt
Gewinnabführungsvertrag	Gewinnabführungsvertrag
Gadsdorfer	Gadsdorfer
eingetragenen	eingetragen
Notgeschäftsführer	Notgeschäftsführer
Sieglinde	Sieglinde
Tankanlage	Tankanlage
Hanredder	Hanredder
Kunz	Kunz
Volkmar	Volkmar
Borst	Borst
Desweiteren	Desweiteren
Rohrreinigung	Rohrreinigung
Bollert	Bollert
medizinischen	medizinisch
einmalig	einmalig
Bottrop	Bottrop
Paritätische	Paritätische
Betonfertigteilen	Betonfertigteilen
Lothar	Lothar
Waren	Ware
Teltow	Teltow
landschaftliche	landschaftlich
Schöntauf	Schöntauf
Mit	mit
E	E
Spedition	Spedition
gmbh	gmbh
Ausführung	Ausführung
Pant	Pant
Kiewitt	Kiewitt
Sicherheitsmaßnahmen	Sicherheitsmaßnahme
alleinvertretungsberechtigten	alleinvertretungsberechtigten
Schulners	Schulners
Abweisung	Abweisung
Slowinski	Slowinski
Birkholz	Birkholz
Baustoffe	Baustoff
Wolke	Wolke
Matthesius	Matthesius
SGS	SGS
Geändert	ändern
Weinstadt	Weinstadt
Frank	Frank
Konkursverfahren	Konkursverfahren
Harald	Harald
Ciacci	Ciacci
Verkaufs	Verkauf
Arbeitsförderungsgesetz	Arbeitsförderungsgesetz
Emler	Emler
Sportgeräten	Sportgerät
Wagatha	Wagatha
Elmshorn	Elmshorn
zusammen	zusammen
behinderten	behindert
Robby	Robby
Börsentagen	Börsentagen
notierten	notiert
Aline	Aline
allen	alle
Kerstin	Kerstin
Wettbewerbsverbot	Wettbewerbsverbot
Wohnraum	Wohnraum
Heidemarie	Heidemarie
Kobert	Kobert
arbeitsloser	arbeitslos
Vladimir	Vladimir
Nutzungsrechte	Nutzungsrechte
Betriebes	Betrieb
handelt	handeln
Böcker	Böcker
Bereinigung	Bereinigung
Jahre	Jahr
Renova	Renova
GA	GA
Gerlingen	Gerlingen
KiStra	KiStra
Gebäulichkeiten	Gebäulichkeiten
Otto	Otto
Michelbach	Michelbach
Wesentlichen	Wesentliche
Burger	Burger
J.	J.
ALAN	ALAN
Laufzeit	Laufzeit
Manthey	Manthey
Tobien	Tobien
Hoffknecht	Hoffknecht
Petzold	Petzold
Vorstand	Vorstand
Kersten	Kersten
Schaaf	Schaaf
Christiane	Christiane
Markt	Markt
Enge	Enge
Gemeinschaftsanlagen	Gemeinschaftsanlage
Erforschung	Erforschung
ordentliche	ordentlich
Erbpacht	Erbpacht
alkoholischen	alkoholisch
Scheewe	Scheewe
Annerose	Annerose
Marlis	Marlis
Stolper	stolpern
Subunternehmer	Subunternehmer
Gernot	Gernot
ausgegebener	ausgegeben
Geschäftsbauvorhaben	Geschäftsbauvorhaben
Berechtigten	Berechtigte
Futteraufbereitung	Futteraufbereitung
Gloeck	Gloeck
Lietzow	Lietzow
Harthe	Harthe
Optionsscheine	Optionsschein
Stechow	Stechow
Altena	Altena
Misterek	Misterek
Grundkapial	Grundkapial
Spangenberg	Spangenberg
Starkstrom	Starkstrom
Pensionierung	Pensionierung
Schnee	Schnee
Aufgabe	Aufgabe
Knappe	Knappe
gleich	gleich
Kalika	Kalika
Zentrale	Zentrale
daran	daran
Gewinnverrechnung	Gewinnverrechnung
Unternehmen	Unternehmen
Verfahrens	Verfahren
Heine	Heine
Benno	Benno
Erwerb	Erwerb
Paragrafen	Paragraf
privaten	privat
Landschafts	Landschafts
steuerbegünstigte	steuerbegünstigt
eigene	eigen
Erdbauarbeiten	Erdbauarbeiten
führt	führen
Lehmann	Lehmann
Food	food
Gill	Gill
Maxen	Maxen
Schöttler	Schöttler
Röske	Röske
Dieses	dies
Rangsdorf	Rangsdorf
Gebäudeausrüstung	Gebäudeausrüstung
Kurka	Kurka
Jürgen	Jürgen
Metzger	Metzger
Hoehle	Hoehle
Geschäftshäusern	Geschäftshaus
Maschinenbauerzeugnissen	Maschinenbauerzeugnissen
Schrader	Schrader
Henke	Henke
Pächtern	Pächter
abzuschließen	abschließen
Jahresabschluss	Jahresabschluss
Einziehungsvergütung	Einziehungsvergütung
Brigitte	Brigitte
Jehne	Jehne
Einzelprokuristen	Einzelprokuristen
insbesondere	insbesondere
Henry	Henry
abspaltenden	abspaltenden
Göhler	Göhler
Komplementärstellung	Komplementärstellung
Ketzin	Ketzin
HTBV	HTBV
Dalichow	Dalichow
Südwest	Südwest
Roland	Roland
Fechner	Fechner
Konferenzzentrums	Konferenzzentren
Duisburg	Duisburg
Brick	Brick
Treuhand	Treuhand
Rose	Rose
Reichelt	Reichelt
Schreiber	Schreiber
Sygula	Sygula
Brillenfassungen	Brillenfassung
innerhalb	innerhalb
Gertraude	Gertraude
R.	R.
Buder	Buder
Ville	Ville
Genshagen	Genshagen
worden	werden
Kuhnert	Kuhnert
langfristigen	langfristig
Gerald	Gerald
Lichtinformationssysteme	Lichtinformationssysteme
Kyritz	Kyritz
infolge	infolge
Entsorgungssicherheit	Entsorgungssicherheit
Schuhmacher	Schuhmacher
Habeck	Habeck
Ausbach	Ausbach
Durchschnittswert	Durchschnittswert
Seltmann	Seltmann
Groth	Groth
Fliesenverlege	Fliesenverlege
Die	d
Umstellung	Umstellung
Walldorf	Walldorf
Kuß	Kuß
Dachdeckerarbeiten	Dachdeckerarbeiten
Holz	Holz
Frankenfelde	Frankenfelde
Bauelementehandel	Bauelementehandel
MSAS	MSAS
Frohne	Frohne
befreien	befreien
Reichert	Reichert
Plaue	Plaue
erfolgten	erfolgt
Einziehung	Einziehung
Mirjana	Mirjana
Leistungen	Leistung
Rotberg	Rotberg
Pinneberg	Pinneberg
v.d.H.	v.d.H.
bevorzugt	bevorzugt
Freiraumplanung	Freiraumplanung
bauablaufbegleitender	bauablaufbegleitender
Bürocomputer	Bürocomputer
Komplementär	komplementär
entsprechend	entsprechend
Müglitztal	Müglitztal
Winsen	Winsen
zurückzuzahlen	zurückzahlen
Vreden	Vreden
GmbH_&_Co._KG	GmbH_&_Co._KG
erlassen	erlassen
Ärztehaus	Ärztehaus
Wolfenbüttel	Wolfenbüttel
Stimmrecht	Stimmrecht
Verwaltungsrat	Verwaltungsrat
Bondarenko	Bondarenko
BAUSAN	BAUSAN
Aufgabenbereiche	Aufgabenbereich
Energieverbrauchseinrichtungen	Energieverbrauchseinrichtungen
ausgeben	ausgeben
Monica	Monica
Röring	Röring
auch	auch
Pegnitz	Pegnitz
Pade	Pade
Braach	Braach
Catrin	Catrin
Ostprignitz	Ostprignitz
Dreilinden	Dreilinden
Körte	Körte
Thiele	Thiele
den	d
Havel	Havel
Bautentrocknungsgewerbe	Bautentrocknungsgewerbe
Hieslmair	Hieslmair
Alpina	Alpina
Kausch	Kausch
Schachtzabel	Schachtzabel
unternehmerischen	unternehmerisch
Geldeinlagen	Geldeinlage
Endfinanzierungen	Endfinanzierungen
Großbeeren	Großbeere
Hesse	Hesse
Jacob	Jacob
Nicolai	Nicolai
AG	AG
einzelne	einzeln
Augusburg	Augusburg
Gesellschaftsversammlung	Gesellschaftsversammlung
Visbek	Visbek
Einziehungsentgelt	Einziehungsentgelt
Alexander	Alexander
Bettwaren	Bettwaren
e	E
Randolph	Randolph
Wirtschaftsgütern	Wirtschaftsgut
salvatorische	salvatorische
Daufenbach	Daufenbach
Schega	Schega
genehmigtes	genehmigt
Tiefbauleistungen	Tiefbauleistungen
überwachungsbedürftigen	überwachungsbedürftig
Mittelspannung	Mittelspannung
Rostock	Rostock
Altfriedland	Altfriedland
Radislav	Radislav
Akustik	Akustik
wirtschaftliche	wirtschaftlich
Komplementärin	Komplementärin
OPAL	Opal
Dietrich	Dietrich
anderem	ander
Kongressen	Kongreß
Zerenner	Zerenner
Weitergabe	Weitergabe
KAYSER	KAYSER
Prof._Dr.	Prof._Dr.
Rattunde	Rattunde
Hinsicht	Hinsicht
Freisen	Freisen
GTU	GTU
Patric	Patric
Feriengebietes	Feriengebietes
Hannelore	Hannelore
Berressen	Berressen
Zellendorf	Zellendorf
Westf.	Westf.
Fliesenlegen	Fliesenlegen
Mauerhoff	Mauerhoff
Befugnisse	Befugnis
Züchner	Züchner
unterschreitet	unterschreiten
Eintragung	Eintragung
Wriezen	Wriezen
Prüfung	Prüfung
Zusammensetzung	Zusammensetzung
m.	m.
BVD	BVD
Aufhebung	Aufhebung
Partnerschaft	Partnerschaft
Innenausstattungen	Innenausstattung
Oranienburg	Oranienburg
Rieck	Rieck
Wiesenburg	Wiesenburg
Gebäudeservice	Gebäudeservice
Aufnahme	Aufnahme
Berk	Berk
Grundstücksgesellschaft	Grundstücksgesellschaft
Hausmeisterservice	Hausmeisterservice
MediMax	MediMax
Weppen	Weppen
Hamann	Hamann
Fassaden	Fassade
Medrow	Medrow
Speiseresten	Speiserest
Resch	Resch
vertretungsberechtigt	vertretungsberechtigt
Kommunikationsprojekten	Kommunikationsprojekten
Klonz	Klonz
Wohnräumen	Wohnräumen
Vornahme	Vornahme
Ghassem	Ghassem
Büro	Büro
Christel	Christel
Schamuhn	Schamuhn
Leopold	Leopold
Selbstkontrahierens	Selbstkontrahierens
weiteren	weit
For	for
Abriß	Abriß
Trebbin	Trebbin
Fassung	Fassung
Grundbesitz	Grundbesitz
abwassertechnischer	abwassertechnischer
nebst	nebst
eintragung	Eintragung
Seher	Seher
Stade	Stade
Insolvenzverfahren	Insolvenzverfahren
Wohlfahrtszwecke	Wohlfahrtszwecke
Handelsleistungen	Handelsleistungen
Kommanditeinlage	Kommanditeinlage
Josipa	Josipa
Geschäftsführern	Geschäftsführer
Förderungen	Förderung
Liese	Liese
Riederich	Riederich
Ruhl	Ruhl
Getränkegroßhandel	Getränkegroßhandel
Siegrid	Siegrid
zu	zu
Kapitalbeträge	Kapitalbeträge
Bens	Bens
Hoebel	Hoebel
Erteilung	Erteilung
Folge	Folge
Gerstenberger	Gerstenberger
Projektmanagement	Projektmanagement
Siegsdorf	Siegsdorf
erster	erst
Krongut	Krongut
Nachtrag	Nachtrag
Doyen	Doyen
Karp	Karp
Stadt	Stadt
Northbrook	Northbrook
Heinrichs	Heinrichs
Veränderung	Veränderung
Baum	Baum
Teilgewinnabführungsvertrag	Teilgewinnabführungsvertrag
fachlichen	fachlich
Schmitz	Schmitz
Fabrikplanung	Fabrikplanung
Skär	Skär
Ergebnisverwendung	Ergebnisverwendung
Rast	Rast
Helmstedt	Helmstedt
Sägedienst	Sägedienst
Thomys	Thomys
Hauptniederlasssung	Hauptniederlasssung
Wurstwarenproduktion	Wurstwarenproduktion
soziale	sozial
Rüdesheim	Rüdesheim
Urbscheit	Urbscheit
Asphalt	Asphalt
Bernau	Bernau
Recht	Recht
Anhänger	Anhänger
Grafiken	Grafik
Willem	Willem
maßnahmen	maßnehmen
Sandler	Sandler
e.K	e.K
Bodenverwertungs	Bodenverwertungs
Peim	Peim
Dommitzsch	Dommitzsch
Müller	Müller
Golm	Golm
Sidney	Sidney
Anderson	Anderson
Vermögens	Vermögen
Rhld	Rhld
Buir	Buir
Ebertz	Ebertz
Knoppick	Knoppick
Kassin	Kassin
Thilo	Thilo
Klockau	Klockau
Planungs	Planungs
Einschränkungen	Einschränkung
Grötsch	Grötsch
Meisel	Meisel
Komplexkomponenten	Komplexkomponenten
Fechter	Fechter
Weitendorf	Weitendorf
kommunalen	kommunal
Kropp	Kropp
Erlangung	Erlangung
Rechtsgeschäften	Rechtsgeschäft
eigenen	eigen
Zapfholzweg	Zapfholzweg
Eberstadt	Eberstadt
Bitterfeld	Bitterfeld
geb.a	geb.a
Deffner	Deffner
anderer	ander
Isselburg	Isselburg
Alleininhaber	Alleininhaber
Rohstoffen	Rohstoff
Berzl	Berzl
Miosga	Miosga
Anna	Anna
Products	Products
Enger	Enge
Neuburg	Neuburg
Motor	Motor
Großer	Große
Natursteinmaterialien	Natursteinmaterialien
Mordhorst	Mordhorst
b	B
Freital	Freital
kulturelle	kulturell
vermittelte	vermittelt
Übernahme	Übernahme
beschränken	beschränken
ETB	ETB
Neujahr	Neujahr
Investor	Investor
Balk	Balk
Unna	Unna
Nachschusspflicht	Nachschusspflicht
Gordon	Gordon
Stein	Stein
Rathenow	Rathenow
Rechts	Recht
Gottgetreu	Gottgetreu
Clemens	Clemens
Scheifler	Scheifler
Urs	Ur
Grewe	Grewe
verfolgt	verfolgen
Marseille	Marseille
Sinnig	sinnig
Gösling	Gösling
Gräfelfing	Gräfelfing
Viola	Viola
Fletcher	Fletcher
Helene	Helene
Tätigkeiten	Tätigkeit
Den	d
Handelstagen	Handelstagen
Stephanie	Stephanie
Michael	Michael
Datenverarbeitungsprogrammen	Datenverarbeitungsprogrammen
z.	z.
Marc	Marc
Putz	Putz
Susan	Susan
Winkel	Winkel
Montan	Montan
Käthe	Käthe
Siethen	Siethen
Wagner	Wagner
belasten	belasten
Eveline	Eveline
Versandhandel	Versandhandel
Schmidt	Schmidt
Daniel	Daniel
Heitkamp	Heitkamp
Zeitler	Zeitler
Heimtextilien	Heimtextilie
AJ	AJ
Senzig	Senzig
Cincinnati	Cincinnati
Losse	Losse
Victorowitsch	Victorowitsch
Landesabfallgesetze	Landesabfallgesetze
Optionspreis	Optionspreis
Dittmann	Dittmann
SAFE	Safe
Carola	Carola
Geschäftsführers	Geschäftsführer
Canada	Canada
Brandis	Brandis
Hauptversammlung	Hauptversammlung
Kleta	Kleta
volle	voll
Gestaltung	Gestaltung
Verpachtung	Verpachtung
Laubisch	Laubisch
Brandt	Brandt
sicherheitssysteme	Sicherheitssystem
Pause	Pause
Logistics	Logistics
CY	CY
Handke	Handke
Balkowski	Balkowski
sofern	sofern
Steckel	Steckel
Herbert	Herbert
Einberufung	Einberufung
dass	dass
übergegangen	übergehen
vom	vom
Tatjana	Tatjana
Castrop	Castrop
nunmehr	nunmehr
SERVICE	Service
Gerdes	Gerdes
Bienitz	Bienitz
Erbingung	Erbingung
Formwechsels	Formwechsels
vorstehenden	vorstehend
Johanning	Johanning
jährliche	jährlich
Calor	Calor
Hanke	Hanke
Rötha	Rötha
Kapitalausstattung	Kapitalausstattung
Neuwerder	Neuwerder
d.	d.
B	B
Anleger	Anleger
Helmut	Helmut
Handelsservice	Handelsservice
neuer	neu
VIERSEITHOF	VIERSEITHOF
Deckung	Deckung
Salzbrunn	Salzbrunn
Holtgreve	Holtgreve
Krausch	Krausch
Konstantin	Konstantin
ordnungsgemäß	ordnungsgemäß
König	König
Ist	sein
Härtel	Härtel
Beschluss	Beschluss
Döberitz	Döberitz
Ergebnisabführungsvereinbarung	Ergebnisabführungsvereinbarung
Grüßing	Grüßing
Altenheimen	Altenheim
Lobin	Lobin
Sanddorn	Sanddorn
Oberländer	Oberland
Worm	Worm
Kuhr	Kuhr
Axel	Axel
GKU	GKU
Heerklotz	Heerklotz
Reichardt	Reichardt
Wintergartenzentrum	Wintergartenzentrum
Eschenbach	Eschenbach
eingeteilt	einteilen
Wolff	Wolff
Aufbereitung	Aufbereitung
Industrial	Industrial
um	um
Kommditistin	Kommditistin
Markus	Markus
Abfallwirtschaft	Abfallwirtschaft
Geschäfte	Geschäft
Kreis	Kreis
Lichtblau	Lichtblau
Stephan	Stephan
Tätigkeitsbereich	Tätigkeitsbereich
beschränkter	beschränkt
Allgemeines	Allgemeine
Rabe	Rabe
Bröckling	Bröckling
Media	Media
Aktie	Aktie
übernommen	übernehmen
Nicolaus	Nicolaus
Halbe	Halbe
Schlusstermins	Schlusstermins
Förderung	Förderung
Hebezeugen	Hebezeugen
Ilse	Ilse
Grassau	Grassau
Inhabern	Inhaber
Schendel	Schendel
Jarucz	Jarucz
Klasdorf	Klasdorf
Steckelsdorf	Steckelsdorf
Todes	Tod
Juwelier	Juwelier
Uta	Uta
Projekt	Projekt
Ebert	Ebert
BUNG	BUNG
Rosner	Rosner
Puchte	Puchte
Spaltungs	Spaltungs
Vonderau	Vonderau
Tismer	Tismer
Hambrusch	Hambrusch
Erfahrungsaustausch	Erfahrungsaustausch
einzelner	einzeln
Everken	Everken
Klaje	Klaje
Ingangsetzung	Ingangsetzung
Antje	Antje
Arbeitsbeschaffungsmaßnahmen	Arbeitsbeschaffungsmaßnahme
Gartengestaltung	Gartengestaltung
Gotthard	Gotthard
TGG	TGG
Norman	Norman
Speiserestverwertungsanlage	Speiserestverwertungsanlage
Moritz	Moritz
Krug	Krug
Vegelahn	Vegelahn
Treuenbrietzen	Treuenbrietzen
Trinkwasserversorgung	Trinkwasserversorgung
Betonarbeiten	Betonarbeiten
Jess	Jess
Je	je
Stammkapial	Stammkapial
Befriedigung	Befriedigung
Bjoern	Bjoern
Morcinkowski	Morcinkowski
Doris	Doris
Durchschnittskursberechnung	Durchschnittskursberechnung
Henske	Henske
Sputnik	Sputnik
Tanksäule	Tanksäule
als	als
O.	O.
Egeln	Egel
PROFIMARKT	PROFIMARKT
notwendig	notwendig
Durchschnittskurs	Durchschnittskurs
Ecoplan	Ecoplan
Grundlage	Grundlage
Erledigung	Erledigung
Servicebereich	Servicebereich
gemeinschaftlich	gemeinschaftlich
beläuft	belaufen
Zdravko	Zdravko
am	am
Gerhard	Gerhard
Verwaltungs	Verwaltungs
Hansa	Hansa
Artikeln	Artikel
Kliem	Kliem
Heinze	Heinze
CJ	CJ
UmweltService	Umweltservice
Knufinke	Knufinke
Vicente	Vicente
Zug	Zug
Kapital	Kapital
Drenkelfort	Drenkelfort
Industrie	Industrie
SPM	SPM
Grundbesitzes	Grundbesitz
derartiger	derartig
Messen	Messen
Schirbaum	Schirbaum
gleicher	gleich
May	May
Ostrau	Ostrau
Personal	Personal
Baillet	Baillet
Weinheim	Weinheim
Konkursverfahrens	Konkursverfahren
Centre	Centre
Sicherheits	Sicherheits
Toralf	Toralf
Oberursel	Oberursel
Eigenwillig	eigenwillig
Liersch	Liersch
Verschmelzung	Verschmelzung
Zahlung	Zahlung
Wunderlich	wunderlich
Einfügung	Einfügung
Steinhude	Steinhude
von	von
notwendiger	notwendig
Sonderrechte	Sonderrechte
Ringleben	Ringleben
Bochum	Bochum
Publikationen	Publikation
genehmigten	genehmigt
EMK	EMK
verwalteten	verwaltet
Pia	Pia
Gängler	Gängler
Gläubigern	Gläubiger
Nürnberg	Nürnberg
DHL	DHL
PreussenElektra	PreussenElektra
Niederlehme	Niederlehm
psychologischen	psychologisch
Grimm	Grimm
elektromechanischen	elektromechanisch
Einräumung	Einräumung
Draber	Draber
Dortmund	Dortmund
s	s
Fabrice	Fabrice
Ostwald	Ostwald
einetreten	einetreten
unterhalten	unterhalten
Galley	Galley
Gottland	Gottland
kann	können
Quartals	Quartal
Fertigungs	Fertigungs
Postel	Postel
Petershausen	Petershausen
teilweiser	teilweise
SYNANON	SYNANON
Auflösung	Auflösung
Ottersbach	Ottersbach
Prüfabors	Prüfabors
Höner	Höner
Nutzungsrechten	Nutzungsrechten
Hays	Hays
geänder	geänder
Langen	Langen
ablauforganisatorischer	ablauforganisatorischer
Boden	Boden
Verzollungen	Verzollungen
Weißenhorn	Weißenhorn
Klemens	Klemens
Planungsgesellschaft	Planungsgesellschaft
Scheuermann	Scheuermann
Institute	Institut
Verbot	Verbot
Verwaltungsbau	Verwaltungsbau
Philippe	Philippe
Zustimmung	Zustimmung
Finowfurt	Finowfurt
Amortisation	Amortisation
Forderungen	Forderung
Company	Company
Barthold	barthold
Sicherheitsberatung	Sicherheitsberatung
Nennwertaktien	Nennwertaktien
Holzbach	Holzbach
es	es
Haßfeld	Haßfeld
übertragende	übertragend
Lüdcke	Lüdcke
zustehen	zustehen
artverwandtem	artverwandtem
Edgar	Edgar
Heidelberg	Heidelberg
AktG	AktG
Marzentowicz	Marzentowicz
Eckhardt	Eckhardt
Land	Land
Fußboden	Fußböden
vorhandenen	vorhanden
Allservice	Allservice
Nimmermann	Nimmermann
Meckenheim	Meckenheim
Erschließungsträger	Erschließungsträger
börsennotierten	börsennotiert
vormals	vormals
Jaeger	Jaeger
Schmager	Schmager
Doberlug	Doberlug
Telgte	Telgte
SANH	SANH
Peter	Peter
Aachen	Aachen
Götz	Götz
Abfindungsentgeltes	Abfindungsentgeltes
Spyrantis	Spyrantis
technischen	technisch
Gemäß	gemäß
Lösungen	Lösung
enthält	enthalten
Teschner	Teschner
Abé	Abé
Baubetreuung	Baubetreuung
Rechnungslegung	Rechnungslegung
Denschel	Denschel
Altmann	Altmann
Büderich	Büderich
Börsenkurse	Börsenkurs
Systems	System
Montagedienstleistungen	Montagedienstleistungen
Buchhaltungsdienstleistungen	Buchhaltungsdienstleistungen
de	de
Zeitablauf	Zeitablauf
Giebelhausen	Giebelhausen
Pforr	Pforr
Rathsack	Rathsack
Belegschaftsaktien	Belegschaftsaktie
Frentz	Frentz
Böhlke	Böhlke
Jansen	Jansen
Walter	Walter
Boo	Boo
Landahl	Landahl
Bekanntmachungen	Bekanntmachung
seit	seit
Czempiel	Czempiel
Querengässer	Querengässer
Knäbich	Knäbich
Börsenkurses	Börsenkurs
Baczko	Baczko
Krohn	Krohn
Voth	Voth
Ruth	Ruth
Rita	Rita
Sportboothafens	Sportboothafens
Heurich	Heurich
Bewirtschaftung	Bewirtschaftung
Anordnung	Anordnung
Terra	Terra
Barth	Barth
Vertrieb	Vertrieb
Hagemann	Hagemann
Gross	Gross
Lautsch	Lautsch
Bergh	Bergh
Altenpflegeheime	Altenpflegeheim
Horst	Horst
Rechtsgeschäft	Rechtsgeschäft
Gericht	Gericht
Zentner	Zentner
Poltz	Poltz
Düsseldorf	Düsseldorf
Lüftungsinstallation	Lüftungsinstallation
Pfeiffer	Pfeiffer
Energie	Energie
Campeau	Campeau
Isenburg	Isenburg
Sattelzugmaschine	Sattelzugmaschine
Boese	Boese
Zschokke	Zschokke
Schäfer	Schäfer
Auftragnehmern	Auftragnehmer
Mathias	Mathias
Anlagen	Anlage
aufgehobenen	aufgehoben
H.	H.
Uhlig	Uhlig
desjenigen	desjenigen
Schöppler	Schöppler
Vorstandsmitglied	Vorstandsmitglied
nominal	nominal
Forschungsaktivitäten	Forschungsaktivität
Elze	Elze
Hegeman	Hegeman
Settele	Settele
Cornelia	Cornelia
Nieder	Nieder
W.	W.
Gilching	Gilching
Niemczyk	Niemczyk
Kaufer	Kaufer
Bauregie	Bauregie
Haakmann	Haakmann
Wientzek	Wientzek
dadurch	dadurch
Klammt	Klammt
Norderstedt	Norderstedt
Cerstin	Cerstin
Gemeinschaftseinrichtungen	Gemeinschaftseinrichtung
Konzeption	Konzeption
Leuthen	Leuthen
Sievershagen	Sievershagen
Blust	Blust
Völker	Volk
bestimmte	bestimmt
Kfz	Kfz
Bewältigung	Bewältigung
Neumann	Neumann
Bau	Bau
möbeln	möbeln
Jon	Jon
Scherfenberg	Scherfenberg
Zossen	Zossen
Müncheberg	Müncheberg
Bauherr	Bauherr
CGIS	CGIS
Seitz	Seitz
schaffen	schaffen
Zeising	Zeising
Heilmann	Heilmann
Freistellungs	Freistellungs
Osama	Osama
Neueinteilung	Neueinteilung
Grundkapitals	Grundkapital
Cohrs	Cohrs
Einzelkaufmann	Einzelkaufmann
übernehmen	übernehmen
Dazu	dazu
Heinen	Heinen
Groß	Groß
Steuerberatungsgesellschaft	Steuerberatungsgesellschaft
Glindow	Glindow
Beschlüssen	Beschluß
Reno	Reno
Döberitzer	Döberitzer
festgesetzten	festgesetzt
Fast	fast
Kaiser	Kaiser
Metzner	Metzner
Gelegenheiten	Gelegenheit
Simulation	Simulation
ermittelt	ermitteln
Rogler	Rogler
Trockenbauhandwerks	Trockenbauhandwerks
Rechnung	Rechnung
eine	ein
anfallenden	anfallend
Jürn	Jürn
AL	AL
Weimann	Weimann
Optionsrechts	Optionsrecht
gesamten	gesamt
Schenkenberg	Schenkenberg
Antennenanlagen	Antennenanlage
Jost	Jost
Sturm	Sturm
Aktivitäten	Aktivität
Strobl	Strobl
Preil	Preil
Fehrbellin	Fehrbellin
Töplitz	Töplitz
Drews	Drews
persönlich	persönlich
Firmenbezeichnung	Firmenbezeichnung
Hein	Hein
Egmont	Egmont
einer	ein
Koch	Koch
Naturstein	Naturstein
Gerhardt	Gerhardt
Buchweitz	Buchweitz
Zahl	Zahl
Almuth	Almuth
für	für
Rögels	Rögels
Ekkehard	Ekkehard
Urkunde	Urkunde
gewandelten	gewandelt
Mitarbeitern	Mitarbeiter
Schwake	Schwake
Vermögensanlagen	Vermögensanlage
Saalower	Saalower
Regensburg	Regensburg
Böhm	Böhm
Guxhagen	Guxhagen
hierfür	hierfür
Erden	Erden
zentrale	zentral
Elvira	Elvira
näherer	nah
Dipl.-Ingenieur	Dipl.-Ingenieur
Diern	Diern
Abschlüsse	Abschluß
Froesch	Froesch
Annette	Annette
Vermittlung	Vermittlung
Wandlungsbedingungen	Wandlungsbedingungen
Informations	Informations
Eingliederungshilfe	Eingliederungshilfe
gegebenenfalls	gegebenenfalls
Räumen	Räumen
Konzerns	Konzern
grundsätzlich	grundsätzlich
Brandhoff	Brandhoff
Liepe	Liepe
Poet	Poet
Klug	Klug
Gravenpolder	Gravenpolder
Chemnitz	Chemnitz
Brüßing	Brüßing
Evelyne	Evelyne
Hard	Hard
Urbach	Urbach
Schweikert	Schweikert
Donau	Donau
rechtlicher	rechtlich
touristischen	touristisch
dazugehörigen	dazugehörig
Karpzow	Karpzow
Wienke	Wienke
Bauernhof	Bauernhof
Umschulung	Umschulung
Ausgabepreis	Ausgabepreis
Güterfelde	Güterfeld
Leschinsky	Leschinsky
Personengesellschaft	Personengesellschaft
Wendeburg	Wendeburg
Unterhaltung	Unterhaltung
Erzeugung	Erzeugung
Torgau	Torgau
Rechtsträger	Rechtsträger
Dinulescu	Dinulescu
Glättung	Glättung
Fröhling	Fröhling
Bauservice	Bauservice
Kreutz	Kreutz
solchen	solch
über	über
unbebauten	unbebaut
Küchen	Küche
Paul	Paul
GfL	GfL
Medienerzeugnissen	Medienerzeugnis
Meßapperaten	Meßapperaten
Bremen	Bremen
haben	haben
Heiligenhafen	Heiligenhäfen
Kommanditisten	Kommanditist
Bauer	Bauer
Mineralölhandel	Mineralölhandel
Rau	Rau
Installation	Installation
Park	Park
stets	stets
Instituten	Institut
Baden	Baden
Union	Union
Schröter	Schröter
Kern	Kern
Spahnharrenstätte	Spahnharrenstätte
Beteiligungsgesellschaften	Beteiligungsgesellschaft
Göttin	Göttin
Masius	Masius
insgesamt	insgesamt
Krebs	Krebs
Weihe	Weihe
Bauingenieur	Bauingenieur
III	III
Altbausanierung	Altbausanierung
Sperling	Sperling
computerintegrierten	computerintegriert
alleinige	alleinig
Gesellschafters	Gesellschafter
Putzhexe	Putzhexe
Kunststoff	Kunststoff
Christina	Christina
Leeker	Leeker
Wohnhäusern	Wohnhaus
BEG	BEG
Preusker	Preusker
Umrechnungskurses	Umrechnungskurses
berechtigt	berechtigen
Kummerow	Kummerow
Schwanenberg	Schwanenberg
Überlassung	Überlassung
Geuking	Geuking
nahe	nahe
Mels	Mels
Tokar	Tokar
Büromanagements	Büromanagements
Vertreter	Vertreter
Märkische	Märkische
Bootscharter	Bootscharter
Irmgard	Irmgard
Brückmann	Brückmann
Blechschmidt	Blechschmidt
UNZE	Unze
Celle	Celle
Schank	Schank
Theodor	Theodor
Tharun	Tharun
Harms	Harm
Miggel	Miggel
mich	ich
Handels	Handel
Hartmann	Hartmann
auf	auf
Nitzsche	Nitzsche
verwiesen	verweisen
Brauchtums	Brauchtum
Verfügung	Verfügung
Maßnahmen	Maßnahme
Obliegenheiten	Obliegenheit
Strencioch	Strencioch
Grunert	Grunert
verlagen	Verlag
Laurens	Laurens
Kühne	Kühne
beschränkt	beschränken
Diethelm	Diethelm
Luitgard	Luitgard
Tremmen	Tremmen
Jakob	Jakob
Volker	Volker
Bayer	Bayer
Kipper	Kipper
handwerklicher	handwerklich
Thürnagel	Thürnagel
ein	ein
Ermittlung	Ermittlung
das	d
Seiffarth	Seiffarth
eingestellt	einstellen
Daimler	Daimler
Verschmelzungsverträge	Verschmelzungsverträge
Knuth	Knuth
abgeschlossen	abschließen
Fichtenwalde	Fichtenwald
St.	St.
Zeiträume	Zeitraum
Berndt	Berndt
Dorothee	Dorothee
Abspaltung	Abspaltung
Neubensdorf	Neubensdorf
Baustellen	Baustellen
Liebertwolkwitz	Liebertwolkwitz
Beer	Beer
Personalüberlassung	Personalüberlassung
Arbeitsmarkt	Arbeitsmarkt
Jankowski	Jankowski
Rohrverlegungsarbeiten	Rohrverlegungsarbeiten
Golzow	Golzow
Ruff	Ruff
EM	EM
F.	F.
Kozelnik	Kozelnik
Unternehmensgruppe	Unternehmensgruppe
zugleich	zugleich
Banken	Bank
Gebäudetechnik	Gebäudetechnik
Ausrüstungen	Ausrüstung
Neckarsulm	Neckarsulm
Inga	Inga
Scheffrahn	Scheffrahn
Holzhausen	Holzhausen
Suhl	Suhl
vertreten	vertreten
4a	4a
ASITO	ASITO
Badke	Badke
Erhöhungsbetrag	Erhöhungsbetrag
Einteilung	Einteilung
Finanzierungen	Finanzierung
Lintorf	Lintorf
Seer	Seer
Gonsult	Gonsult
Rechte	Rechte
Couveinhes	Couveinhes
BLG	BLG
Saalkreis	Saalkreis
Weißenfels	Weißenfels
Christof	Christof
Wandel	Wandel
außer	außer
Grundbesitzverwaltung	Grundbesitzverwaltung
Rohsäften	Rohsäften
Stöckigt	Stöckigt
Entwicklungs	Entwicklungs
Stuttgart	Stuttgart
Böck	Böck
Sporthaus	Sporthaus
Becker	Becker
Rüger	Rüger
Heinz	Heinz
Erhard	Erhard
Rosemarie	Rosemarie
Integration	Integration
Ausschliessung	Ausschliessung
übernimmt	übernehmen
Marenbach	Marenbach
Europäischen	europäisch
Trägern	Träger
Frédéric	Frédéric
Schroller	Schroller
Bad	Bad
Herdecke	Herdecke
vermieten	vermieten
Gewinnbeteiligung	Gewinnbeteiligung
Standortentwicklung	Standortentwicklung
Hochheuser	Hochheuser
Fleischer	Fleischer
Hirschmann	Hirschmann
solcher	solch
Möhlihs	Möhlihs
Gemüseverarbeitung	Gemüseverarbeitung
Odenwald	Odenwald
Führungs	Führungs
arithmetischen	arithmetisch
Laudin	Laudin
Dienstleistungen	Dienstleistung
Rübner	Rübner
Tonne	Tonne
Berwanger	Berwanger
wesentlich	wesentlich
darin	darin
Jensen	Jensen
Fanzloch	Fanzloch
verzinsliche	verzinslich
Handelsmarken	Handelsmarke
Systeme	System
Meyer	Meyer
No	No
OP	OP
Antonio	Antonio
Satzung	Satzung
Teppich	Teppich
A.	A.
Spielgeräten	Spielgerät
Timmer	Timmer
CLASSIK	CLASSIK
Wilms	Wilms
Währungsunion	Währungsunion
Dietze	Dietze
Holldorf	Holldorf
Structured	Structured
Hoyer	Hoyer
gefährdet	gefährden
Umwandlungsrechts	Umwandlungsrechts
Spaltung	Spaltung
Baugewerbe	Baugewerbe
Wissenschaftler	Wissenschaftler
Grund	Grund
ausgegeben	ausgeben
Bootsmotoren	Bootsmotor
Willi	Willi
Rommel	Rommel
Verträge	Vertrag
Kindertagesstätten	Kindertagesstätte
Löschung	Löschung
Birkhorst	Birkhorst
benötigten	benötigen
Verkehrsanlagen	Verkehrsanlage
Befreiung	Befreiung
Kutzner	Kutzner
auszuführen	ausführen
Marcus	Marcus
Schmiale	Schmiale
dienlich	dienlich
Weimar	Weimar
Taute	tauen
electronic	electronic
drei	drei
Beratungsleistungen	Beratungsleistung
Vierraden	Vierraden
Arno	Arno
Dreier	dreier
dritten	dritt
Sanierungs	Sanierungs
John	John
Fracht	Fracht
dann	dann
Wiesbaden	Wiesbaden
verbleibenden	verbleibend
seinen	sein
größer	groß
Höttler	Höttler
Matsukawa	Matsukawa
ihres	ihr
Bretschneider	Bretschneider
Yilmaz	Yilmaz
Nerlich	Nerlich
Hrdlitschka	Hrdlitschka
befreit	befreien
Schleising	Schleising
100%igen	100%igen
Reparatur	Reparatur
Ulzburg	Ulzburg
Kroh	Kroh
Heidenreich	Heidenreich
Bock	Bock
Waltersdorf	Waltersdorf
Groh	Groh
Entsorgungskonzepten	Entsorgungskonzepten
Wildau	Wildau
KfZ	KfZ
Kenin	Kenin
Raschemann	Raschemann
Scheunemann	Scheunemann
EURO	EURO
Fortleitung	Fortleitung
Krause	Krause
Parant	Parant
Kompletterschließungen	Kompletterschließungen
Tochtergesellschaften	Tochtergesellschaft
Schwabe	Schwabe
Nordheim	Nordheim
Baumaschinen	Baumaschine
Gadsdorf	Gadsdorf
Wandelrechts	Wandelrechts
Lamac	Lamac
Oeynhausen	Oeynhausen
fort	fort
Zweigniederlassung	Zweigniederlassung
Vogler	Vogler
Konkurseröffnung	Konkurseröffnung
Ankaufs	Ankauf
Erweiterung	Erweiterung
Reigstergericht	Reigstergericht
Vorstandsmitglieder	Vorstandsmitglied
Insgesamt	insgesamt
Andreas	Andreas
Wedemark	Wedemark
Standortfaktoren	Standortfaktor
Baran	Baran
Emden	Emden
neuen	neu
abzüglich	abzüglich
Magdeburg	Magdeburg
Seemann	Seemann
Objektservice	Objektservice
Wohnraumversorgung	Wohnraumversorgung
innerbetrieblichen	innerbetrieblich
Eckhard	Eckhard
Sinn	Sinn
Monika	Monika
Schmees	Schmees
Sicherheit	Sicherheit
Schmid	Schmid
Salzwedel	Salzwedel
Sterilisatoren	Sterilisatoren
Michel	Michel
Staib	Staib
Abwickler	Abwickler
Gemeinde	Gemeinde
Eisenhüttenstadt	Eisenhüttenstadt
Mosser	Mosser
Kapitalerhöhung	Kapitalerhöhung
Pirna	Pirna
Heitele	Heitele
oHG.	oHG.
Wohnräume	Wohnraum
Lasseck	Lasseck
Premnitz	Premnitz
Gesellschaft_mit_beschränkter_Haftung	Gesellschaft_mit_beschränkter_Haftung
Dipl.-Ing	Dipl.-Ing
Golke	Golke
Rackith	Rackith
Diepensee	Diepensee
auszugebenden	auszugebend
Spezialitäten	Spezialität
Emission	Emission
Entsorgungsverträgen	Entsorgungsverträgen
begonnen	beginnen
Gröhn	Gröhn
Chemieprodukten	Chemieprodukt
Rietz	Rietz
Helsing	Helsing
Eduard	Eduard
Stüber	Stüber
herabgesetzt	herabsetzen
Rechten	Rechten
Knaute	Knaute
Herabsetzung	Herabsetzung
Grundmann	Grundmann
übersteigt	übersteigen
ordnungsgemäßen	ordnungsgemäß
Display	Display
Krankenhäusern	Krankenhaus
Felix	Felix
Zeitraums	Zeitraum
Wohnen	Wohnen
Mundt	Mundt
ferner	fern
Vercharterung	Vercharterung
Bewässerungsanlagen	Bewässerungsanlage
Klose	Klose
Einhausen	Einhausen
Preus	Preus
Kahl	kahl
Kulturarbeiter	Kulturarbeiter
Zemke	Zemke
Jansa	Jansa
Dritte	Dritte
Mögelin	Mögelin
Marktbäckerei	Marktbäckerei
Systemengineering	Systemengineering
beziehen	beziehen
Filmtheater	Filmtheater
Solmon	Solmon
Troitzsch	Troitzsch
möglich	möglich
Güternah	Güternah
wobei	wobei
außerordentlichen	außerordentlich
beträgt	betragen
Düsterdiek	Düsterdiek
leisten	leisten
Hackbarth	Hackbarth
Reik	Reik
Heino	Heino
Bornheim	Bornheim
Apotheke	Apotheke
Register	Register
Brilon	Brilon
Schweden	Schweden
jeweilige	jeweilig
Börsenpreis	Börsenpreis
Rustler	Rustler
Tagesende	Tagesende
erweitert	erweitern
Matos	Matos
bestimmen	bestimmen
Tobias	Tobias
Meerveld	Meerveld
Deutsche	deutsch
usw.	usw.
Neuss	Neuss
Ute	Ute
Draht	Draht
Zwischen	zwischen
Wackrow	Wackrow
kommt	kommen
141a	141a
wirtschafts	wirtschafts
Dokumentationserstellungen	Dokumentationserstellungen
Reutlingen	Reutlingen
Bautzen	Bautzen
Güler	Güler
Böhnki	Böhnki
management	Management
Ucke	Ucke
kleine	klein
Hälsig	Hälsig
Karin	Karin
Puchta	Puchta
STEPHAN	STEPHAN
Schüler	Schüler
erhöht	erhöhen
PLAN	planen
Optionsrechten	Optionsrechten
oder	oder
Wache	Wache
Begrenzungssystemen	Begrenzungssystemen
Voorburg	Voorburg
Ash	Ash
Geschäftsleitungen	Geschäftsleitung
Hirschberg	Hirschberg
Hauptniederlassung	Hauptniederlassung
Herward	Herward
Weidlich	weidlich
Mühlberger	Mühlberger
Yee	Yee
Ney	Ney
Datenhaltung	Datenhaltung
Beherrschungs	Beherrschungs
Spiegelstrich	Spiegelstrich
Sonderregelungen	Sonderregelung
Klepzig	Klepzig
Vertrages	Vertrag
Reeck	Reeck
Micaela	Micaela
beratende	beratend
Schnitzer	Schnitzer
Ziem	Ziem
Präsidialausschusses	Präsidialausschusses
M	M
Hager	hager
Wildpark	Wildpark
D.A.E.	D.A.E.
Wansing	Wansing
Pflaster	Pflaster
Kunzack	Kunzack
Erschließungsanlagen	Erschließungsanlage
optischen	optisch
Referenzperioden	Referenzperioden
Gesellschafterbeschluss	Gesellschafterbeschluss
Sadik	Sadik
i.	in
Repke	Repke
Rehagen	Rehagen
Richard	Richard
Kerth	Kerth
Paunzhausen	Paunzhausen
mit	mit
Behnke	Behnke
beruht	beruhen
Weißkopf	Weißkopf
Endprodukte	Endprodukt
Teichert	Teichert
Weichenwerk	Weichenwerk
Grafenau	Grafenau
Landes	Land
Freizeitbedarfs	Freizeitbedarfs
ALBA	ALBA
Brück	Brück
Veljko	Veljko
Gesamtprokurist	Gesamtprokurist
Vorkauf	Vorkauf
Kommanditist	Kommanditist
Dressel	Dressel
sind	sein
Untersuchungen	Untersuchung
Berücksichtigung	Berücksichtigung
Tresorbau	Tresorbau
Seebruck	Seebruck
Sterlyn	Sterlyn
Sorge	Sorge
Strittmatter	Strittmatter
Schielicke	Schielicke
Kösterke	Kösterke
BilanzG	BilanzG
Eva	Eva
Oppelt	Oppelt
Krafft	Krafft
Brünig	Brünig
Baustoffen	Baustoff
Pye	Pye
Rhinow	Rhinow
Angela	Angela
alkoholfreien	alkoholfrei
Jahnke	Jahnke
Augenoptik	Augenoptik
Ott	Ott
Klausdorf	Klausdorf
Insolvenzmasse	Insolvenzmasse
Fachplanungsleistungen	Fachplanungsleistungen
Durchführung	Durchführung
Wandlungsrechte	Wandlungsrechte
Jürg	Jürg
geworden	werden
Paßmann	Paßmann
Petershagen	Petershagen
Überwachungsaufgaben	Überwachungsaufgabe
Bülent	Bülent
Christine	Christine
folgt	folgen
Bank	Bank
Heitmann	Heitmann
Manipulation	Manipulation
redaktionelle	redaktionell
Ahaus	Ahaus
Johannes	Johannes
Ingvar	Ingvar
Alwin	Alwin
Gollwitz	Gollwitz
Kiene	Kiene
Cierzynski	Cierzynski
Wassersportservice	Wassersportservice
Hähnel	Hähnel
MediaMax	MediaMax
Alleinvertretungsrecht	Alleinvertretungsrecht
Gebäudereinigungsunternehmen	Gebäudereinigungsunternehmen
Taunus	Taunus
Darmstadt	Darmstadt
Hessler	Hessler
Baram	Baram
übertragbar	übertragbar
Organschafts	Organschafts
Multimediaprodukten	Multimediaprodukten
Nächst	nächst
Marquardt	Marquardt
Schiffdorf	Schiffdorf
bare	bar
Gebäudereinigungsgesellschaft	Gebäudereinigungsgesellschaft
Nennhausen	Nennhausen
gleichen	gleich
Joint	Joint
Spielfilmen	Spielfilmen
Bergholz	Bergholz
Abschluß	Abschluß
Meß	Meß
Zantis	Zantis
zusätzliche	zusätzlich
Leirich	Leirich
Leasingverträge	Leasingvertrag
daher	daher
Luftfedersysteme	Luftfedersysteme
Koschkin	Koschkin
betriebswirtschaftliche	betriebswirtschaftlich
Przyborowski	Przyborowski
Gunnar	Gunnar
Aufsichtsratsmitglieder	Aufsichtsratsmitglied
Abschnittes	Abschnitt
Hohlstein	Hohlstein
Kaminbau	Kaminbau
Neuruppin	Neuruppin
Pfitzner	Pfitzner
eingefügt	einfügen
Jüterboger	Jüterboger
Piper	Piper
Gustavus	Gustavus
Stahn	Stahn
Karner	Karner
Unabhängigkeit	Unabhängigkeit
Schreiter	Schreiter
Schönfeld	Schönfeld
Gösta	Gösta
stillen	still
Bezugsrechts	Bezugsrecht
mildtätige	mildtätig
Marktforschung	Marktforschung
einschließlich	einschließlich
Viernheim	Viernheim
Kommunalen	Kommunale
Ekaterina	Ekaterina
Langholz	Langholz
Namensaktien	Namensaktie
M.C.F.	M.C.F.
Staller	Staller
Hansetel	Hansetel
Albert	Albert
Neuheim	Neuheim
Heithausen	Heithausen
GOLD	Gold
Teile	Teil
Arkades	Arkades
Ronald	Ronald
Mittelberg	Mittelberg
Mühlhausen	Mühlhausen
Isabelle	Isabelle
sodann	sodann
Bekanntmachung	Bekanntmachung
Datenschutz	Datenschutz
notwendigen	notwendig
Bautätigkeit	Bautätigkeit
Anpassungen	Anpassung
Detlev	Detlev
Erwerber	Erwerber
Aufgrund	aufgrund
BVVG	BVVG
Caputh	Caputh
Hove	Hove
Reinhard	Reinhard
Lohmann	Lohmann
Cizek	Cizek
Kurth	Kurth
Leuchten	Leuchten
Haustein	Haustein
Thyrow	Thyrow
Roßtal	Roßtal
stellvertretenden	stellvertretend
Gebrauchsgüterindustrie	Gebrauchsgüterindustrie
Sanitäranlagen	Sanitäranlage
Leight	Leight
Vera	Vera
Minsk	Minsk
gültigen	gültig
folgen	folgen
Konzerngesellschaften	Konzerngesellschaft
machen	machen
Manske	Manske
Nordende	Nordende
Erwin	Erwin
Hendrikus	Hendrikus
Schumann	Schumann
Customer	Customer
Gummi	Gummi
Fritjof	Fritjof
Wallenhorst	Wallenhorst
umfaßt	umfassen
Borkheide	Borkheide
Wege	Weg
Landgesellschaft	Landgesellschaft
Wirtschaftsdienste	Wirtschaftsdienst
Friedersdorf	Friedersdorf
Kommanditgesellschaften	Kommanditgesellschaft
angebotenen	angeboten
Lungwitz	Lungwitz
WC	WC
Grahl	Grahl
Condor	Condor
Beschäftigten	Beschäftigte
Walz	walzen
Aloysius	Aloysius
Lübke	Lübke
Abschnitts	Abschnitt
Lacke	Lack
Sterilisationen	Sterilisation
Nidderau	Nidderau
Quellmelz	Quellmelz
Gesamtrechtsnachfolge	Gesamtrechtsnachfolge
Desinfektionsautomaten	Desinfektionsautomaten
errichten	errichten
zusammenhängen	zusammenhängen
Halbjahresergebnisse	Halbjahresergebnis
zum	zum
Lüdicke	Lüdicke
Josef	Josef
jeglicher	jeglich
Flugschule	Flugschule
Rudolf	Rudolf
Zoofachmarkt	Zoofachmarkt
Lingen	Lingen
Versorgung	Versorgung
Herrn	Herr
zwischen	zwischen
Erbringung	Erbringung
Winterfeld	Winterfeld
Erwerbs	Erwerb
Irmin	Irmin
Lauritsen	Lauritsen
Persönlich	persönlich
Buchow	Buchow
m.b.H.	m.b.H.
Kürten	küren
Gemeinschaft	Gemeinschaft
erstgenannten	erstgenannt
Heukenkamp	Heukenkamp
Gesundheits	Gesundheits
Egon	Egon
Mircea	Mircea
Anteilen	Anteilen
Günter	Günter
Straße	Straße
Maklertätigkeit	Maklertätigkeit
Geschäftsanteile	Geschäftsanteil
Kathrin	Kathrin
Maiziére	Maiziére
rechtlichen	rechtlich
Mitarbeit	Mitarbeit
Jung	Jung
Sawade	Sawade
Ermächtigung	Ermächtigung
Umfirmierung	Umfirmierung
weitesten	weit
Gentzsch	Gentzsch
Gründen	Gründen
förderlich	förderlich
Organisationsberatung	Organisationsberatung
Bader	Bader
vollständig	vollständig
besonderen	besonder
Flurstück	Flurstück
Landwirtschaftsbetrieben	Landwirtschaftsbetrieb
Informationsveranstaltungen	Informationsveranstaltung
Dingwort	Dingwort
Geiger	Geiger
beteiligen	beteiligen
Fischbach	Fischbach
Keitz	Keitz
STAHL	stehlen
Gabriele	Gabriele
Simona	Simona
tief	tief
med.	med.
Waldemar	Waldemar
Berufsbildungsgesetzes	Berufsbildungsgesetz
Winterdienst	Winterdienst
Remscheid	Remscheid
Herrnburg	Herrnburg
befaßt	befassen
Strampfer	Strampfer
Massow	Massow
Schlüter	Schlüter
Hütte	Hütte
Bodenschätzen	Bodenschätzen
Kundendienst	Kundendienst
Katharina	Katharina
Beratungs	Beratungs
Weiterhin	weiterhin
cyroa	cyroa
Besch	Besch
Informationstechnologien	Informationstechnologie
Rechtsgeschäfte	Rechtsgeschäft
Klausel	Klausel
jedoch	jedoch
haftenden	haftend
Anja	Anja
Zeidler	Zeidler
ABU	ABU
Marx	Marx
Ricken	Ricken
Kirk	Kirk
Lütkestratkötter	Lütkestratkötter
Hartmut	Hartmut
Betriebs	Betrieb
Klein	Klein
Anlagenverwaltung	Anlagenverwaltung
Belastung	Belastung
Barzuzahlung	Barzuzahlung
Investmentberatung	Investmentberatung
Performanceindex	Performanceindex
Ömer	Ömer
Versicherungsleistungen	Versicherungsleistung
erwerben	erwerben
Tandler	Tandler
Lachmann	Lachmann
soll	sollen
SMB	SMB
Thalia	Thalia
Steuerbegünstigte	Steuerbegünstigte
Teilbetrieb	Teilbetrieb
Garz	Garz
Großschirma	Großschirma
Dienste	Dienst
Linnert	Linnert
Hoffmann	Hoffmann
Erdmute	Erdmut
Köhler	Köhler
HEVAG	HEVAG
Juso	Juso
Marketingstrategien	Marketingstrategie
Babelsberg	Babelsberg
persönliche	persönlich
Keilholz	Keilholz
Velp	Velp
Bruno	Bruno
Epoxidbeschichtungen	Epoxidbeschichtungen
Schreibweise	Schreibweise
Butzbacher	Butzbacher
übernehmender	übernehmender
Agrarprodukten	Agrarprodukt
Investitionsgüter	Investitionsgut
Lunderstädt	Lunderstädt
Verwendung	Verwendung
and	and
Unternehmensberatung	Unternehmensberatung
Kruse	Kruse
Datenspeicheranlage	Datenspeicheranlage
Heimwerkerbedarf	Heimwerkerbedarf
Verhältnisse	Verhältnis
Diemert	Diemert
firmierend	firmierend
Vermögensteilen	Vermögensteilen
Inge	Inge
Betreibung	Betreibung
Eckardt	Eckardt
Margitta	Margitta
Burkhard	Burkhard
Bürmann	Bürmann
Gießen	Gießen
Umbauten	Umbauten
Japke	Japke
Schiffel	Schiffel
Schönefeld	Schönefeld
gehandelt	handeln
Minnie	Minnie
Neuhardenberg	Neuhardenberg
Amtsdauer	Amtsdauer
Consulting	Consulting
Optionsanleihen	Optionsanleihen
Bienenstein	Bienenstein
Schaldach	Schaldach
ausscheidender	ausscheidend
HVL	HVL
Heide	Heide
Architektur	Architektur
erfolgen	erfolgen
Annaburg	Annaburg
Bund	Bund
Knapp	Knapp
Microelectronic	Microelectronic
Eberswalde	Eberswald
verbundenen	verbunden
computerintegrierter	computerintegrierter
Köppel	Köppel
Witzig	witzig
Ankauf	Ankauf
Winiarski	Winiarski
AETNA	AETNA
Städtebaus	Städtebau
WBG	WBG
betreuen	betreuen
Speisenwirtschaften	Speisenwirtschaften
aufnehmender	aufnehmender
Germany	Germany
Blinne	Blinne
Carsten	Carsten
Bücher	Buch
Notierungen	Notierung
Schlifke	Schlifke
Ersatzteilen	Ersatzteilen
Schwarzenbek	Schwarzenbek
Senftenberg	Senftenberg
Gegenstand	Gegenstand
Bensdorf	Bensdorf
Ziescht	Ziescht
Bramstedt	Bramstedt
Kiel	Kiel
Fitjer	Fitjer
Lichtenberg	Lichtenberg
diese	dies
Starossom	Starossom
Gesellschafterversammlungen	Gesellschafterversammlung
Mahlow	Mahlow
Preißner	Preißner
Prause	Prause
Geisler	Geisler
handwerklichen	handwerklich
unberührt	unberührt
volkswirtschaftlich	volkswirtschaftlich
Fitzke	Fitzke
Kupfer	Kupfer
Ausner	Ausner
mangels	mangels
Hatwieger	Hatwieger
Bark	Bark
Piegler	Piegler
Verwertungsgesellschaft	Verwertungsgesellschaft
Prozesse	Prozeß
Röhricht	Röhricht
Annegret	Annegret
Sonstiges	Sonstige
Lübeck	Lübeck
Wohnungsbau	Wohnungsbau
Blüthgen	Blüthgen
Gegenstände	Gegenstand
Kuhnke	Kuhnke
gründende	gründend
Schandert	Schandert
Junker	Junker
Grundkapital	Grundkapital
Manis	Manis
Fertig	fertig
Hausverwaltung	Hausverwaltung
Mietern	Mieter
VS	VS
Gesellschaftszwecks	Gesellschaftszwecks
Anteil	Anteil
Eichwalde	Eichwald
Vorkaufsrecht	Vorkaufsrecht
anerkannten	anerkannt
Sorg	sorgen
K	K
Ein	ein
Hille	Hille
Gesamtprokuristen	Gesamtprokuristen
Kalms	Kalms
Oderhaff	Oderhaff
technische	technisch
Haus	Haus
Blähton	Blähton
vorzunehmen	vornehmen
Bestimmungen	Bestimmung
Schlangen	Schlange
Antrag	Antrag
zweiten	zweit
C.	C.
Germanus	Germanus
Dresden	Dresden
Tagungen	Tagung
festgelegten	festgelegt
Schüren	Schüren
Geschäftsprozessen	Geschäftsprozessen
Restle	Restle
Dolgenbrodt	Dolgenbrodt
Inning	Inning
Eberhard	Eberhard
Christophe	Christophe
Grothe	Grothe
Einlagen	Einlage
Satzungsänderung	Satzungsänderung
Lampertheim	Lampertheim
Köhne	Köhne
Enderlein	Enderlein
Drexler	Drexler
seiner	sein
m	m
Möbel	Möbel
lautende	lautend
Festlegung	Festlegung
Nicht	nicht
Beschlüsse	Beschluß
Hentzschel	Hentzschel
Wusterhausen	Wusterhausen
allem	alle
Hertel	Hertel
Rudolph	Rudolph
